Id	Scope	Ref_Name
aaa	I	Ghotuo
aab	I	Alumu-Tesu
aac	I	Ari
aad	I	Amal
aae	I	Arbëreshë Albanian
aaf	I	Aranadan
aag	I	Ambrak
aah	I	Abu' Arapesh
aai	I	Arifama-Miniafia
aak	I	Ankave
aal	I	Afade
aan	I	Anambé
aao	I	Algerian Saharan Arabic
aap	I	Pará Arára
aaq	I	Eastern Abnaki
aar	I	Afar
aas	I	Aasáx
aat	I	Arvanitika Albanian
aau	I	Abau
aaw	I	Solong
aax	I	Mandobo Atas
aaz	I	Amarasi
aba	I	Abé
abb	I	Bankon
abc	I	Ambala Ayta
abd	I	Manide
abe	I	Western Abnaki
abf	I	Abai Sungai
abg	I	Abaga
abh	I	Tajiki Arabic
abi	I	Abidji
abj	I	Aka-Bea
abk	I	Abkhazian
abl	I	Lampung Nyo
abm	I	Abanyom
abn	I	Abua
abo	I	Abon
abp	I	Abellen Ayta
abq	I	Abaza
abr	I	Abron
abs	I	Ambonese Malay
abt	I	Ambulas
abu	I	Abure
abv	I	Baharna Arabic
abw	I	Pal
abx	I	Inabaknon
aby	I	Aneme Wake
abz	I	Abui
aca	I	Achagua
acb	I	Áncá
acd	I	Gikyode
ace	I	Achinese
acf	I	Saint Lucian Creole French
ach	I	Acoli
aci	I	Aka-Cari
ack	I	Aka-Kora
acl	I	Akar-Bale
acm	I	Mesopotamian Arabic
acn	I	Achang
acp	I	Eastern Acipa
acq	I	Ta'izzi-Adeni Arabic
acr	I	Achi
acs	I	Acroá
act	I	Achterhoeks
acu	I	Achuar-Shiwiar
acv	I	Achumawi
acw	I	Hijazi Arabic
acx	I	Omani Arabic
acy	I	Cypriot Arabic
acz	I	Acheron
ada	I	Adangme
adb	I	Atauran
add	I	Lidzonka
ade	I	Adele
adf	I	Dhofari Arabic
adg	I	Andegerebinha
adh	I	Adhola
adi	I	Adi
adj	I	Adioukrou
adl	I	Galo
adn	I	Adang
ado	I	Abu
adq	I	Adangbe
adr	I	Adonara
ads	I	Adamorobe Sign Language
adt	I	Adnyamathanha
adu	I	Aduge
adw	I	Amundava
adx	I	Amdo Tibetan
ady	I	Adyghe
adz	I	Adzera
aea	I	Areba
aeb	I	Tunisian Arabic
aec	I	Saidi Arabic
aed	I	Argentine Sign Language
aee	I	Northeast Pashai
aek	I	Haeke
ael	I	Ambele
aem	I	Arem
aen	I	Armenian Sign Language
aeq	I	Aer
aer	I	Eastern Arrernte
aes	I	Alsea
aeu	I	Akeu
aew	I	Ambakich
aey	I	Amele
aez	I	Aeka
afb	I	Gulf Arabic
afd	I	Andai
afe	I	Putukwam
afg	I	Afghan Sign Language
afh	I	Afrihili
afi	I	Akrukay
afk	I	Nanubae
afn	I	Defaka
afo	I	Eloyi
afp	I	Tapei
afr	I	Afrikaans
afs	I	Afro-Seminole Creole
aft	I	Afitti
afu	I	Awutu
afz	I	Obokuitai
aga	I	Aguano
agb	I	Legbo
agc	I	Agatu
agd	I	Agarabi
age	I	Angal
agf	I	Arguni
agg	I	Angor
agh	I	Ngelima
agi	I	Agariya
agj	I	Argobba
agk	I	Isarog Agta
agl	I	Fembe
agm	I	Angaataha
agn	I	Agutaynen
ago	I	Tainae
agq	I	Aghem
agr	I	Aguaruna
ags	I	Esimbi
agt	I	Central Cagayan Agta
agu	I	Aguacateco
agv	I	Remontado Dumagat
agw	I	Kahua
agx	I	Aghul
agy	I	Southern Alta
agz	I	Mt. Iriga Agta
aha	I	Ahanta
ahb	I	Axamb
ahg	I	Qimant
ahh	I	Aghu
ahi	I	Tiagbamrin Aizi
ahk	I	Akha
ahl	I	Igo
ahm	I	Mobumrin Aizi
ahn	I	Àhàn
aho	I	Ahom
ahp	I	Aproumu Aizi
ahr	I	Ahirani
ahs	I	Ashe
aht	I	Ahtena
aia	I	Arosi
aib	I	Ainu (China)
aic	I	Ainbai
aid	I	Alngith
aie	I	Amara
aif	I	Agi
aig	I	Antigua and Barbuda Creole English
aih	I	Ai-Cham
aii	I	Assyrian Neo-Aramaic
aij	I	Lishanid Noshan
aik	I	Ake
ail	I	Aimele
aim	I	Aimol
ain	I	Ainu (Japan)
aio	I	Aiton
aip	I	Burumakok
aiq	I	Aimaq
air	I	Airoran
ait	I	Arikem
aiw	I	Aari
aix	I	Aighon
aiy	I	Ali
aja	I	Aja (South Sudan)
ajg	I	Aja (Benin)
aji	I	Ajië
ajn	I	Andajin
ajs	I	Algerian Jewish Sign Language
aju	I	Judeo-Moroccan Arabic
ajw	I	Ajawa
ajz	I	Amri Karbi
aka	M	Akan
akb	I	Batak Angkola
akc	I	Mpur
akd	I	Ukpet-Ehom
ake	I	Akawaio
akf	I	Akpa
akg	I	Anakalangu
akh	I	Angal Heneng
aki	I	Aiome
akj	I	Aka-Jeru
akk	I	Akkadian
akl	I	Aklanon
akm	I	Aka-Bo
ako	I	Akurio
akp	I	Siwu
akq	I	Ak
akr	I	Araki
aks	I	Akaselem
akt	I	Akolet
aku	I	Akum
akv	I	Akhvakh
akw	I	Akwa
akx	I	Aka-Kede
aky	I	Aka-Kol
akz	I	Alabama
ala	I	Alago
alc	I	Qawasqar
ald	I	Alladian
ale	I	Aleut
alf	I	Alege
alh	I	Alawa
ali	I	Amaimon
alj	I	Alangan
alk	I	Alak
all	I	Allar
alm	I	Amblong
aln	I	Gheg Albanian
alo	I	Larike-Wakasihu
alp	I	Alune
alq	I	Algonquin
alr	I	Alutor
als	I	Tosk Albanian
alt	I	Southern Altai
alu	I	'Are'are
alw	I	Alaba-K’abeena
alx	I	Amol
aly	I	Alyawarr
alz	I	Alur
ama	I	Amanayé
amb	I	Ambo
amc	I	Amahuaca
ame	I	Yanesha'
amf	I	Hamer-Banna
amg	I	Amurdak
amh	I	Amharic
ami	I	Amis
amj	I	Amdang
amk	I	Ambai
aml	I	War-Jaintia
amm	I	Ama (Papua New Guinea)
amn	I	Amanab
amo	I	Amo
amp	I	Alamblak
amq	I	Amahai
amr	I	Amarakaeri
ams	I	Southern Amami-Oshima
amt	I	Amto
amu	I	Guerrero Amuzgo
amv	I	Ambelau
amw	I	Western Neo-Aramaic
amx	I	Anmatyerre
amy	I	Ami
amz	I	Atampaya
ana	I	Andaqui
anb	I	Andoa
anc	I	Ngas
and	I	Ansus
ane	I	Xârâcùù
anf	I	Animere
ang	I	Old English (ca. 450-1100)
anh	I	Nend
ani	I	Andi
anj	I	Anor
ank	I	Goemai
anl	I	Anu-Hkongso Chin
anm	I	Anal
ann	I	Obolo
ano	I	Andoque
anp	I	Angika
anq	I	Jarawa (India)
anr	I	Andh
ans	I	Anserma
ant	I	Antakarinya
anu	I	Anuak
anv	I	Denya
anw	I	Anaang
anx	I	Andra-Hus
any	I	Anyin
anz	I	Anem
aoa	I	Angolar
aob	I	Abom
aoc	I	Pemon
aod	I	Andarum
aoe	I	Angal Enen
aof	I	Bragat
aog	I	Angoram
aoi	I	Anindilyakwa
aoj	I	Mufian
aok	I	Arhö
aol	I	Alor
aom	I	Ömie
aon	I	Bumbita Arapesh
aor	I	Aore
aos	I	Taikat
aot	I	Atong (India)
aou	I	A'ou
aox	I	Atorada
aoz	I	Uab Meto
apb	I	Sa'a
apc	I	Levantine Arabic
apd	I	Sudanese Arabic
ape	I	Bukiyip
apf	I	Pahanan Agta
apg	I	Ampanang
aph	I	Athpariya
api	I	Apiaká
apj	I	Jicarilla Apache
apk	I	Kiowa Apache
apl	I	Lipan Apache
apm	I	Mescalero-Chiricahua Apache
apn	I	Apinayé
apo	I	Ambul
app	I	Apma
apq	I	A-Pucikwar
apr	I	Arop-Lokep
aps	I	Arop-Sissano
apt	I	Apatani
apu	I	Apurinã
apv	I	Alapmunte
apw	I	Western Apache
apx	I	Aputai
apy	I	Apalaí
apz	I	Safeyoka
aqc	I	Archi
aqd	I	Ampari Dogon
aqg	I	Arigidi
aqk	I	Aninka
aqm	I	Atohwaim
aqn	I	Northern Alta
aqp	I	Atakapa
aqr	I	Arhâ
aqt	I	Angaité
aqz	I	Akuntsu
ara	M	Arabic
arb	I	Standard Arabic
arc	I	Official Aramaic (700-300 BCE)
ard	I	Arabana
are	I	Western Arrarnta
arg	I	Aragonese
arh	I	Arhuaco
ari	I	Arikara
arj	I	Arapaso
ark	I	Arikapú
arl	I	Arabela
arn	I	Mapudungun
aro	I	Araona
arp	I	Arapaho
arq	I	Algerian Arabic
arr	I	Karo (Brazil)
ars	I	Najdi Arabic
aru	I	Aruá (Amazonas State)
arv	I	Arbore
arw	I	Arawak
arx	I	Aruá (Rodonia State)
ary	I	Moroccan Arabic
arz	I	Egyptian Arabic
asa	I	Asu (Tanzania)
asb	I	Assiniboine
asc	I	Casuarina Coast Asmat
ase	I	American Sign Language
asf	I	Auslan
asg	I	Cishingini
ash	I	Abishira
asi	I	Buruwai
asj	I	Sari
ask	I	Ashkun
asl	I	Asilulu
asm	I	Assamese
asn	I	Xingú Asuriní
aso	I	Dano
asp	I	Algerian Sign Language
asq	I	Austrian Sign Language
asr	I	Asuri
ass	I	Ipulo
ast	I	Asturian
asu	I	Tocantins Asurini
asv	I	Asoa
asw	I	Australian Aborigines Sign Language
asx	I	Muratayak
asy	I	Yaosakor Asmat
asz	I	As
ata	I	Pele-Ata
atb	I	Zaiwa
atc	I	Atsahuaca
atd	I	Ata Manobo
ate	I	Atemble
atg	I	Ivbie North-Okpela-Arhe
ati	I	Attié
atj	I	Atikamekw
atk	I	Ati
atl	I	Mt. Iraya Agta
atm	I	Ata
atn	I	Ashtiani
ato	I	Atong (Cameroon)
atp	I	Pudtol Atta
atq	I	Aralle-Tabulahan
atr	I	Waimiri-Atroari
ats	I	Gros Ventre
att	I	Pamplona Atta
atu	I	Reel
atv	I	Northern Altai
atw	I	Atsugewi
atx	I	Arutani
aty	I	Aneityum
atz	I	Arta
aua	I	Asumboa
aub	I	Alugu
auc	I	Waorani
aud	I	Anuta
aug	I	Aguna
auh	I	Aushi
aui	I	Anuki
auj	I	Awjilah
auk	I	Heyo
aul	I	Aulua
aum	I	Asu (Nigeria)
aun	I	Molmo One
auo	I	Auyokawa
aup	I	Makayam
auq	I	Anus
aur	I	Aruek
aut	I	Austral
auu	I	Auye
auw	I	Awyi
aux	I	Aurá
auy	I	Awiyaana
auz	I	Uzbeki Arabic
ava	I	Avaric
avb	I	Avau
avd	I	Alviri-Vidari
ave	I	Avestan
avi	I	Avikam
avk	I	Kotava
avl	I	Eastern Egyptian Bedawi Arabic
avm	I	Angkamuthi
avn	I	Avatime
avo	I	Agavotaguerra
avs	I	Aushiri
avt	I	Au
avu	I	Avokaya
avv	I	Avá-Canoeiro
awa	I	Awadhi
awb	I	Awa (Papua New Guinea)
awc	I	Cicipu
awe	I	Awetí
awg	I	Anguthimri
awh	I	Awbono
awi	I	Aekyom
awk	I	Awabakal
awm	I	Arawum
awn	I	Awngi
awo	I	Awak
awr	I	Awera
aws	I	South Awyu
awt	I	Araweté
awu	I	Central Awyu
awv	I	Jair Awyu
aww	I	Awun
awx	I	Awara
awy	I	Edera Awyu
axb	I	Abipon
axe	I	Ayerrerenge
axg	I	Mato Grosso Arára
axk	I	Yaka (Central African Republic)
axl	I	Lower Southern Aranda
axm	I	Middle Armenian
axx	I	Xârâgurè
aya	I	Awar
ayb	I	Ayizo Gbe
ayc	I	Southern Aymara
ayd	I	Ayabadhu
aye	I	Ayere
ayg	I	Ginyanga
ayh	I	Hadrami Arabic
ayi	I	Leyigha
ayk	I	Akuku
ayl	I	Libyan Arabic
aym	M	Aymara
ayn	I	Sanaani Arabic
ayo	I	Ayoreo
ayp	I	North Mesopotamian Arabic
ayq	I	Ayi (Papua New Guinea)
ayr	I	Central Aymara
ays	I	Sorsogon Ayta
ayt	I	Magbukun Ayta
ayu	I	Ayu
ayz	I	Mai Brat
aza	I	Azha
azb	I	South Azerbaijani
azd	I	Eastern Durango Nahuatl
aze	M	Azerbaijani
azg	I	San Pedro Amuzgos Amuzgo
azj	I	North Azerbaijani
azm	I	Ipalapa Amuzgo
azn	I	Western Durango Nahuatl
azo	I	Awing
azt	I	Faire Atta
azz	I	Highland Puebla Nahuatl
baa	I	Babatana
bab	I	Bainouk-Gunyuño
bac	I	Badui
bae	I	Baré
baf	I	Nubaca
bag	I	Tuki
bah	I	Bahamas Creole English
baj	I	Barakai
bak	I	Bashkir
bal	M	Baluchi
bam	I	Bambara
ban	I	Balinese
bao	I	Waimaha
bap	I	Bantawa
bar	I	Bavarian
bas	I	Basa (Cameroon)
bau	I	Bada (Nigeria)
bav	I	Vengo
baw	I	Bambili-Bambui
bax	I	Bamun
bay	I	Batuley
bba	I	Baatonum
bbb	I	Barai
bbc	I	Batak Toba
bbd	I	Bau
bbe	I	Bangba
bbf	I	Baibai
bbg	I	Barama
bbh	I	Bugan
bbi	I	Barombi
bbj	I	Ghomálá'
bbk	I	Babanki
bbl	I	Bats
bbm	I	Babango
bbn	I	Uneapa
bbo	I	Northern Bobo Madaré
bbp	I	West Central Banda
bbq	I	Bamali
bbr	I	Girawa
bbs	I	Bakpinka
bbt	I	Mburku
bbu	I	Kulung (Nigeria)
bbv	I	Karnai
bbw	I	Baba
bbx	I	Bubia
bby	I	Befang
bca	I	Central Bai
bcb	I	Bainouk-Samik
bcc	I	Southern Balochi
bcd	I	North Babar
bce	I	Bamenyam
bcf	I	Bamu
bcg	I	Baga Pokur
bch	I	Bariai
bci	I	Baoulé
bcj	I	Bardi
bck	I	Bunuba
bcl	I	Central Bikol
bcm	I	Bannoni
bcn	I	Bali (Nigeria)
bco	I	Kaluli
bcp	I	Bali (Democratic Republic of Congo)
bcq	I	Bench
bcr	I	Babine
bcs	I	Kohumono
bct	I	Bendi
bcu	I	Awad Bing
bcv	I	Shoo-Minda-Nye
bcw	I	Bana
bcy	I	Bacama
bcz	I	Bainouk-Gunyaamolo
bda	I	Bayot
bdb	I	Basap
bdc	I	Emberá-Baudó
bdd	I	Bunama
bde	I	Bade
bdf	I	Biage
bdg	I	Bonggi
bdh	I	Baka (South Sudan)
bdi	I	Burun
bdj	I	Bai (South Sudan)
bdk	I	Budukh
bdl	I	Indonesian Bajau
bdm	I	Buduma
bdn	I	Baldemu
bdo	I	Morom
bdp	I	Bende
bdq	I	Bahnar
bdr	I	West Coast Bajau
bds	I	Burunge
bdt	I	Bokoto
bdu	I	Oroko
bdv	I	Bodo Parja
bdw	I	Baham
bdx	I	Budong-Budong
bdy	I	Bandjalang
bdz	I	Badeshi
bea	I	Beaver
beb	I	Bebele
bec	I	Iceve-Maci
bed	I	Bedoanas
bee	I	Byangsi
bef	I	Benabena
beg	I	Belait
beh	I	Biali
bei	I	Bekati'
bej	I	Beja
bek	I	Bebeli
bel	I	Belarusian
bem	I	Bemba (Zambia)
ben	I	Bengali
beo	I	Beami
bep	I	Besoa
beq	I	Beembe
bes	I	Besme
bet	I	Guiberoua Béte
beu	I	Blagar
bev	I	Daloa Bété
bew	I	Betawi
bex	I	Jur Modo
bey	I	Beli (Papua New Guinea)
bez	I	Bena (Tanzania)
bfa	I	Bari
bfb	I	Pauri Bareli
bfc	I	Panyi Bai
bfd	I	Bafut
bfe	I	Betaf
bff	I	Bofi
bfg	I	Busang Kayan
bfh	I	Blafe
bfi	I	British Sign Language
bfj	I	Bafanji
bfk	I	Ban Khor Sign Language
bfl	I	Banda-Ndélé
bfm	I	Mmen
bfn	I	Bunak
bfo	I	Malba Birifor
bfp	I	Beba
bfq	I	Badaga
bfr	I	Bazigar
bfs	I	Southern Bai
bft	I	Balti
bfu	I	Gahri
bfw	I	Bondo
bfx	I	Bantayanon
bfy	I	Bagheli
bfz	I	Mahasu Pahari
bga	I	Gwamhi-Wuri
bgb	I	Bobongko
bgc	I	Haryanvi
bgd	I	Rathwi Bareli
bge	I	Bauria
bgf	I	Bangandu
bgg	I	Bugun
bgi	I	Giangan
bgj	I	Bangolan
bgk	I	Bit
bgl	I	Bo (Laos)
bgn	I	Western Balochi
bgo	I	Baga Koga
bgp	I	Eastern Balochi
bgq	I	Bagri
bgr	I	Bawm Chin
bgs	I	Tagabawa
bgt	I	Bughotu
bgu	I	Mbongno
bgv	I	Warkay-Bipim
bgw	I	Bhatri
bgx	I	Balkan Gagauz Turkish
bgy	I	Benggoi
bgz	I	Banggai
bha	I	Bharia
bhb	I	Bhili
bhc	I	Biga
bhd	I	Bhadrawahi
bhe	I	Bhaya
bhf	I	Odiai
bhg	I	Binandere
bhh	I	Bukharic
bhi	I	Bhilali
bhj	I	Bahing
bhl	I	Bimin
bhm	I	Bathari
bhn	I	Bohtan Neo-Aramaic
bho	I	Bhojpuri
bhp	I	Bima
bhq	I	Tukang Besi South
bhr	I	Bara Malagasy
bhs	I	Buwal
bht	I	Bhattiyali
bhu	I	Bhunjia
bhv	I	Bahau
bhw	I	Biak
bhx	I	Bhalay
bhy	I	Bhele
bhz	I	Bada (Indonesia)
bia	I	Badimaya
bib	I	Bissa
bid	I	Bidiyo
bie	I	Bepour
bif	I	Biafada
big	I	Biangai
bik	M	Bikol
bil	I	Bile
bim	I	Bimoba
bin	I	Bini
bio	I	Nai
bip	I	Bila
biq	I	Bipi
bir	I	Bisorio
bis	I	Bislama
bit	I	Berinomo
biu	I	Biete
biv	I	Southern Birifor
biw	I	Kol (Cameroon)
bix	I	Bijori
biy	I	Birhor
biz	I	Baloi
bja	I	Budza
bjb	I	Banggarla
bjc	I	Bariji
bje	I	Biao-Jiao Mien
bjf	I	Barzani Jewish Neo-Aramaic
bjg	I	Bidyogo
bjh	I	Bahinemo
bji	I	Burji
bjj	I	Kanauji
bjk	I	Barok
bjl	I	Bulu (Papua New Guinea)
bjm	I	Bajelani
bjn	I	Banjar
bjo	I	Mid-Southern Banda
bjp	I	Fanamaket
bjr	I	Binumarien
bjs	I	Bajan
bjt	I	Balanta-Ganja
bju	I	Busuu
bjv	I	Bedjond
bjw	I	Bakwé
bjx	I	Banao Itneg
bjy	I	Bayali
bjz	I	Baruga
bka	I	Kyak
bkc	I	Baka (Cameroon)
bkd	I	Binukid
bkf	I	Beeke
bkg	I	Buraka
bkh	I	Bakoko
bki	I	Baki
bkj	I	Pande
bkk	I	Brokskat
bkl	I	Berik
bkm	I	Kom (Cameroon)
bkn	I	Bukitan
bko	I	Kwa'
bkp	I	Boko (Democratic Republic of Congo)
bkq	I	Bakairí
bkr	I	Bakumpai
bks	I	Northern Sorsoganon
bkt	I	Boloki
bku	I	Buhid
bkv	I	Bekwarra
bkw	I	Bekwel
bkx	I	Baikeno
bky	I	Bokyi
bkz	I	Bungku
bla	I	Siksika
blb	I	Bilua
blc	I	Bella Coola
bld	I	Bolango
ble	I	Balanta-Kentohe
blf	I	Buol
blh	I	Kuwaa
bli	I	Bolia
blj	I	Bolongan
blk	I	Pa'o Karen
bll	I	Biloxi
blm	I	Beli (South Sudan)
bln	I	Southern Catanduanes Bikol
blo	I	Anii
blp	I	Blablanga
blq	I	Baluan-Pam
blr	I	Blang
bls	I	Balaesang
blt	I	Tai Dam
blv	I	Kibala
blw	I	Balangao
blx	I	Mag-Indi Ayta
bly	I	Notre
blz	I	Balantak
bma	I	Lame
bmb	I	Bembe
bmc	I	Biem
bmd	I	Baga Manduri
bme	I	Limassa
bmf	I	Bom-Kim
bmg	I	Bamwe
bmh	I	Kein
bmi	I	Bagirmi
bmj	I	Bote-Majhi
bmk	I	Ghayavi
bml	I	Bomboli
bmm	I	Northern Betsimisaraka Malagasy
bmn	I	Bina (Papua New Guinea)
bmo	I	Bambalang
bmp	I	Bulgebi
bmq	I	Bomu
bmr	I	Muinane
bms	I	Bilma Kanuri
bmt	I	Biao Mon
bmu	I	Somba-Siawari
bmv	I	Bum
bmw	I	Bomwali
bmx	I	Baimak
bmz	I	Baramu
bna	I	Bonerate
bnb	I	Bookan
bnc	M	Bontok
bnd	I	Banda (Indonesia)
bne	I	Bintauna
bnf	I	Masiwang
bng	I	Benga
bni	I	Bangi
bnj	I	Eastern Tawbuid
bnk	I	Bierebo
bnl	I	Boon
bnm	I	Batanga
bnn	I	Bunun
bno	I	Bantoanon
bnp	I	Bola
bnq	I	Bantik
bnr	I	Butmas-Tur
bns	I	Bundeli
bnu	I	Bentong
bnv	I	Bonerif
bnw	I	Bisis
bnx	I	Bangubangu
bny	I	Bintulu
bnz	I	Beezen
boa	I	Bora
bob	I	Aweer
bod	I	Tibetan
boe	I	Mundabli
bof	I	Bolon
bog	I	Bamako Sign Language
boh	I	Boma
boi	I	Barbareño
boj	I	Anjam
bok	I	Bonjo
bol	I	Bole
bom	I	Berom
bon	I	Bine
boo	I	Tiemacèwè Bozo
bop	I	Bonkiman
boq	I	Bogaya
bor	I	Borôro
bos	I	Bosnian
bot	I	Bongo
bou	I	Bondei
bov	I	Tuwuli
bow	I	Rema
box	I	Buamu
boy	I	Bodo (Central African Republic)
boz	I	Tiéyaxo Bozo
bpa	I	Daakaka
bpc	I	Mbuk
bpd	I	Banda-Banda
bpe	I	Bauni
bpg	I	Bonggo
bph	I	Botlikh
bpi	I	Bagupi
bpj	I	Binji
bpk	I	Orowe
bpl	I	Broome Pearling Lugger Pidgin
bpm	I	Biyom
bpn	I	Dzao Min
bpo	I	Anasi
bpp	I	Kaure
bpq	I	Banda Malay
bpr	I	Koronadal Blaan
bps	I	Sarangani Blaan
bpt	I	Barrow Point
bpu	I	Bongu
bpv	I	Bian Marind
bpw	I	Bo (Papua New Guinea)
bpx	I	Palya Bareli
bpy	I	Bishnupriya
bpz	I	Bilba
bqa	I	Tchumbuli
bqb	I	Bagusa
bqc	I	Boko (Benin)
bqd	I	Bung
bqf	I	Baga Kaloum
bqg	I	Bago-Kusuntu
bqh	I	Baima
bqi	I	Bakhtiari
bqj	I	Bandial
bqk	I	Banda-Mbrès
bql	I	Karian
bqm	I	Wumboko
bqn	I	Bulgarian Sign Language
bqo	I	Balo
bqp	I	Busa
bqq	I	Biritai
bqr	I	Burusu
bqs	I	Bosngun
bqt	I	Bamukumbit
bqu	I	Boguru
bqv	I	Koro Wachi
bqw	I	Buru (Nigeria)
bqx	I	Baangi
bqy	I	Bengkala Sign Language
bqz	I	Bakaka
bra	I	Braj
brb	I	Brao
brc	I	Berbice Creole Dutch
brd	I	Baraamu
bre	I	Breton
brf	I	Bira
brg	I	Baure
brh	I	Brahui
bri	I	Mokpwe
brj	I	Bieria
brk	I	Birked
brl	I	Birwa
brm	I	Barambu
brn	I	Boruca
bro	I	Brokkat
brp	I	Barapasi
brq	I	Breri
brr	I	Birao
brs	I	Baras
brt	I	Bitare
bru	I	Eastern Bru
brv	I	Western Bru
brw	I	Bellari
brx	I	Bodo (India)
bry	I	Burui
brz	I	Bilbil
bsa	I	Abinomn
bsb	I	Brunei Bisaya
bsc	I	Bassari
bse	I	Wushi
bsf	I	Bauchi
bsg	I	Bashkardi
bsh	I	Kati
bsi	I	Bassossi
bsj	I	Bangwinji
bsk	I	Burushaski
bsl	I	Basa-Gumna
bsm	I	Busami
bsn	I	Barasana-Eduria
bso	I	Buso
bsp	I	Baga Sitemu
bsq	I	Bassa
bsr	I	Bassa-Kontagora
bss	I	Akoose
bst	I	Basketo
bsu	I	Bahonsuai
bsv	I	Baga Sobané
bsw	I	Baiso
bsx	I	Yangkam
bsy	I	Sabah Bisaya
bta	I	Bata
btc	I	Bati (Cameroon)
btd	I	Batak Dairi
bte	I	Gamo-Ningi
btf	I	Birgit
btg	I	Gagnoa Bété
bth	I	Biatah Bidayuh
bti	I	Burate
btj	I	Bacanese Malay
btm	I	Batak Mandailing
btn	I	Ratagnon
bto	I	Rinconada Bikol
btp	I	Budibud
btq	I	Batek
btr	I	Baetora
bts	I	Batak Simalungun
btt	I	Bete-Bendi
btu	I	Batu
btv	I	Bateri
btw	I	Butuanon
btx	I	Batak Karo
bty	I	Bobot
btz	I	Batak Alas-Kluet
bua	M	Buriat
bub	I	Bua
buc	I	Bushi
bud	I	Ntcham
bue	I	Beothuk
buf	I	Bushoong
bug	I	Buginese
buh	I	Younuo Bunu
bui	I	Bongili
buj	I	Basa-Gurmana
buk	I	Bugawac
bul	I	Bulgarian
bum	I	Bulu (Cameroon)
bun	I	Sherbro
buo	I	Terei
bup	I	Busoa
buq	I	Brem
bus	I	Bokobaru
but	I	Bungain
buu	I	Budu
buv	I	Bun
buw	I	Bubi
bux	I	Boghom
buy	I	Bullom So
buz	I	Bukwen
bva	I	Barein
bvb	I	Bube
bvc	I	Baelelea
bvd	I	Baeggu
bve	I	Berau Malay
bvf	I	Boor
bvg	I	Bonkeng
bvh	I	Bure
bvi	I	Belanda Viri
bvj	I	Baan
bvk	I	Bukat
bvl	I	Bolivian Sign Language
bvm	I	Bamunka
bvn	I	Buna
bvo	I	Bolgo
bvp	I	Bumang
bvq	I	Birri
bvr	I	Burarra
bvt	I	Bati (Indonesia)
bvu	I	Bukit Malay
bvv	I	Baniva
bvw	I	Boga
bvx	I	Dibole
bvy	I	Baybayanon
bvz	I	Bauzi
bwa	I	Bwatoo
bwb	I	Namosi-Naitasiri-Serua
bwc	I	Bwile
bwd	I	Bwaidoka
bwe	I	Bwe Karen
bwf	I	Boselewa
bwg	I	Barwe
bwh	I	Bishuo
bwi	I	Baniwa
bwj	I	Láá Láá Bwamu
bwk	I	Bauwaki
bwl	I	Bwela
bwm	I	Biwat
bwn	I	Wunai Bunu
bwo	I	Boro (Ethiopia)
bwp	I	Mandobo Bawah
bwq	I	Southern Bobo Madaré
bwr	I	Bura-Pabir
bws	I	Bomboma
bwt	I	Bafaw-Balong
bwu	I	Buli (Ghana)
bww	I	Bwa
bwx	I	Bu-Nao Bunu
bwy	I	Cwi Bwamu
bwz	I	Bwisi
bxa	I	Tairaha
bxb	I	Belanda Bor
bxc	I	Molengue
bxd	I	Pela
bxe	I	Birale
bxf	I	Bilur
bxg	I	Bangala
bxh	I	Buhutu
bxi	I	Pirlatapa
bxj	I	Bayungu
bxk	I	Bukusu
bxl	I	Jalkunan
bxm	I	Mongolia Buriat
bxn	I	Burduna
bxo	I	Barikanchi
bxp	I	Bebil
bxq	I	Beele
bxr	I	Russia Buriat
bxs	I	Busam
bxu	I	China Buriat
bxv	I	Berakou
bxw	I	Bankagooma
bxz	I	Binahari
bya	I	Batak
byb	I	Bikya
byc	I	Ubaghara
byd	I	Benyadu'
bye	I	Pouye
byf	I	Bete
byg	I	Baygo
byh	I	Bhujel
byi	I	Buyu
byj	I	Bina (Nigeria)
byk	I	Biao
byl	I	Bayono
bym	I	Bidjara
byn	I	Bilin
byo	I	Biyo
byp	I	Bumaji
byq	I	Basay
byr	I	Baruya
bys	I	Burak
byt	I	Berti
byv	I	Medumba
byw	I	Belhariya
byx	I	Qaqet
byz	I	Banaro
bza	I	Bandi
bzb	I	Andio
bzc	I	Southern Betsimisaraka Malagasy
bzd	I	Bribri
bze	I	Jenaama Bozo
bzf	I	Boikin
bzg	I	Babuza
bzh	I	Mapos Buang
bzi	I	Bisu
bzj	I	Belize Kriol English
bzk	I	Nicaragua Creole English
bzl	I	Boano (Sulawesi)
bzm	I	Bolondo
bzn	I	Boano (Maluku)
bzo	I	Bozaba
bzp	I	Kemberano
bzq	I	Buli (Indonesia)
bzr	I	Biri
bzs	I	Brazilian Sign Language
bzt	I	Brithenig
bzu	I	Burmeso
bzv	I	Naami
bzw	I	Basa (Nigeria)
bzx	I	Kɛlɛngaxo Bozo
bzy	I	Obanliku
bzz	I	Evant
caa	I	Chortí
cab	I	Garifuna
cac	I	Chuj
cad	I	Caddo
cae	I	Lehar
caf	I	Southern Carrier
cag	I	Nivaclé
cah	I	Cahuarano
caj	I	Chané
cak	I	Kaqchikel
cal	I	Carolinian
cam	I	Cemuhî
can	I	Chambri
cao	I	Chácobo
cap	I	Chipaya
caq	I	Car Nicobarese
car	I	Galibi Carib
cas	I	Tsimané
cat	I	Catalan
cav	I	Cavineña
caw	I	Callawalla
cax	I	Chiquitano
cay	I	Cayuga
caz	I	Canichana
cbb	I	Cabiyarí
cbc	I	Carapana
cbd	I	Carijona
cbg	I	Chimila
cbi	I	Chachi
cbj	I	Ede Cabe
cbk	I	Chavacano
cbl	I	Bualkhaw Chin
cbn	I	Nyahkur
cbo	I	Izora
cbq	I	Tsucuba
cbr	I	Cashibo-Cacataibo
cbs	I	Cashinahua
cbt	I	Chayahuita
cbu	I	Candoshi-Shapra
cbv	I	Cacua
cbw	I	Kinabalian
cby	I	Carabayo
ccc	I	Chamicuro
ccd	I	Cafundo Creole
cce	I	Chopi
ccg	I	Samba Daka
cch	I	Atsam
ccj	I	Kasanga
ccl	I	Cutchi-Swahili
ccm	I	Malaccan Creole Malay
cco	I	Comaltepec Chinantec
ccp	I	Chakma
ccr	I	Cacaopera
cda	I	Choni
cde	I	Chenchu
cdf	I	Chiru
cdh	I	Chambeali
cdi	I	Chodri
cdj	I	Churahi
cdm	I	Chepang
cdn	I	Chaudangsi
cdo	I	Min Dong Chinese
cdr	I	Cinda-Regi-Tiyal
cds	I	Chadian Sign Language
cdy	I	Chadong
cdz	I	Koda
cea	I	Lower Chehalis
ceb	I	Cebuano
ceg	I	Chamacoco
cek	I	Eastern Khumi Chin
cen	I	Cen
ces	I	Czech
cet	I	Centúúm
cey	I	Ekai Chin
cfa	I	Dijim-Bwilim
cfd	I	Cara
cfg	I	Como Karim
cfm	I	Falam Chin
cga	I	Changriwa
cgc	I	Kagayanen
cgg	I	Chiga
cgk	I	Chocangacakha
cha	I	Chamorro
chb	I	Chibcha
chc	I	Catawba
chd	I	Highland Oaxaca Chontal
che	I	Chechen
chf	I	Tabasco Chontal
chg	I	Chagatai
chh	I	Chinook
chj	I	Ojitlán Chinantec
chk	I	Chuukese
chl	I	Cahuilla
chm	M	Mari (Russia)
chn	I	Chinook jargon
cho	I	Choctaw
chp	I	Chipewyan
chq	I	Quiotepec Chinantec
chr	I	Cherokee
cht	I	Cholón
chu	I	Church Slavic
chv	I	Chuvash
chw	I	Chuwabu
chx	I	Chantyal
chy	I	Cheyenne
chz	I	Ozumacín Chinantec
cia	I	Cia-Cia
cib	I	Ci Gbe
cic	I	Chickasaw
cid	I	Chimariko
cie	I	Cineni
cih	I	Chinali
cik	I	Chitkuli Kinnauri
cim	I	Cimbrian
cin	I	Cinta Larga
cip	I	Chiapanec
cir	I	Tiri
ciw	I	Chippewa
ciy	I	Chaima
cja	I	Western Cham
cje	I	Chru
cjh	I	Upper Chehalis
cji	I	Chamalal
cjk	I	Chokwe
cjm	I	Eastern Cham
cjn	I	Chenapian
cjo	I	Ashéninka Pajonal
cjp	I	Cabécar
cjs	I	Shor
cjv	I	Chuave
cjy	I	Jinyu Chinese
ckb	I	Central Kurdish
ckh	I	Chak
ckl	I	Cibak
ckm	I	Chakavian
ckn	I	Kaang Chin
cko	I	Anufo
ckq	I	Kajakse
ckr	I	Kairak
cks	I	Tayo
ckt	I	Chukot
cku	I	Koasati
ckv	I	Kavalan
ckx	I	Caka
cky	I	Cakfem-Mushere
ckz	I	Cakchiquel-Quiché Mixed Language
cla	I	Ron
clc	I	Chilcotin
cld	I	Chaldean Neo-Aramaic
cle	I	Lealao Chinantec
clh	I	Chilisso
cli	I	Chakali
clj	I	Laitu Chin
clk	I	Idu-Mishmi
cll	I	Chala
clm	I	Klallam
clo	I	Lowland Oaxaca Chontal
cls	I	Classical Sanskrit
clt	I	Lautu Chin
clu	I	Caluyanun
clw	I	Chulym
cly	I	Eastern Highland Chatino
cma	I	Maa
cme	I	Cerma
cmg	I	Classical Mongolian
cmi	I	Emberá-Chamí
cml	I	Campalagian
cmm	I	Michigamea
cmn	I	Mandarin Chinese
cmo	I	Central Mnong
cmr	I	Mro-Khimi Chin
cms	I	Messapic
cmt	I	Camtho
cna	I	Changthang
cnb	I	Chinbon Chin
cnc	I	Côông
cng	I	Northern Qiang
cnh	I	Hakha Chin
cni	I	Asháninka
cnk	I	Khumi Chin
cnl	I	Lalana Chinantec
cno	I	Con
cnp	I	Northern Ping Chinese
cnq	I	Chung
cnr	I	Montenegrin
cns	I	Central Asmat
cnt	I	Tepetotutla Chinantec
cnu	I	Chenoua
cnw	I	Ngawn Chin
cnx	I	Middle Cornish
coa	I	Cocos Islands Malay
cob	I	Chicomuceltec
coc	I	Cocopa
cod	I	Cocama-Cocamilla
coe	I	Koreguaje
cof	I	Colorado
cog	I	Chong
coh	I	Chonyi-Dzihana-Kauma
coj	I	Cochimi
cok	I	Santa Teresa Cora
col	I	Columbia-Wenatchi
com	I	Comanche
con	I	Cofán
coo	I	Comox
cop	I	Coptic
coq	I	Coquille
cor	I	Cornish
cos	I	Corsican
cot	I	Caquinte
cou	I	Wamey
cov	I	Cao Miao
cow	I	Cowlitz
cox	I	Nanti
coz	I	Chochotec
cpa	I	Palantla Chinantec
cpb	I	Ucayali-Yurúa Ashéninka
cpc	I	Ajyíninka Apurucayali
cpg	I	Cappadocian Greek
cpi	I	Chinese Pidgin English
cpn	I	Cherepon
cpo	I	Kpeego
cps	I	Capiznon
cpu	I	Pichis Ashéninka
cpx	I	Pu-Xian Chinese
cpy	I	South Ucayali Ashéninka
cqd	I	Chuanqiandian Cluster Miao
cra	I	Chara
crb	I	Island Carib
crc	I	Lonwolwol
crd	I	Coeur d'Alene
cre	M	Cree
crf	I	Caramanta
crg	I	Michif
crh	I	Crimean Tatar
cri	I	Sãotomense
crj	I	Southern East Cree
crk	I	Plains Cree
crl	I	Northern East Cree
crm	I	Moose Cree
crn	I	El Nayar Cora
cro	I	Crow
crq	I	Iyo'wujwa Chorote
crr	I	Carolina Algonquian
crs	I	Seselwa Creole French
crt	I	Iyojwa'ja Chorote
crv	I	Chaura
crw	I	Chrau
crx	I	Carrier
cry	I	Cori
crz	I	Cruzeño
csa	I	Chiltepec Chinantec
csb	I	Kashubian
csc	I	Catalan Sign Language
csd	I	Chiangmai Sign Language
cse	I	Czech Sign Language
csf	I	Cuba Sign Language
csg	I	Chilean Sign Language
csh	I	Asho Chin
csi	I	Coast Miwok
csj	I	Songlai Chin
csk	I	Jola-Kasa
csl	I	Chinese Sign Language
csm	I	Central Sierra Miwok
csn	I	Colombian Sign Language
cso	I	Sochiapam Chinantec
csp	I	Southern Ping Chinese
csq	I	Croatia Sign Language
csr	I	Costa Rican Sign Language
css	I	Southern Ohlone
cst	I	Northern Ohlone
csv	I	Sumtu Chin
csw	I	Swampy Cree
csx	I	Cambodian Sign Language
csy	I	Siyin Chin
csz	I	Coos
cta	I	Tataltepec Chatino
ctc	I	Chetco
ctd	I	Tedim Chin
cte	I	Tepinapa Chinantec
ctg	I	Chittagonian
cth	I	Thaiphum Chin
ctl	I	Tlacoatzintepec Chinantec
ctm	I	Chitimacha
ctn	I	Chhintange
cto	I	Emberá-Catío
ctp	I	Western Highland Chatino
cts	I	Northern Catanduanes Bikol
ctt	I	Wayanad Chetti
ctu	I	Chol
cty	I	Moundadan Chetty
ctz	I	Zacatepec Chatino
cua	I	Cua
cub	I	Cubeo
cuc	I	Usila Chinantec
cuh	I	Chuka
cui	I	Cuiba
cuj	I	Mashco Piro
cuk	I	San Blas Kuna
cul	I	Culina
cuo	I	Cumanagoto
cup	I	Cupeño
cuq	I	Cun
cur	I	Chhulung
cut	I	Teutila Cuicatec
cuu	I	Tai Ya
cuv	I	Cuvok
cuw	I	Chukwa
cux	I	Tepeuxila Cuicatec
cuy	I	Cuitlatec
cvg	I	Chug
cvn	I	Valle Nacional Chinantec
cwa	I	Kabwa
cwb	I	Maindo
cwd	I	Woods Cree
cwe	I	Kwere
cwg	I	Chewong
cwt	I	Kuwaataay
cxh	I	Cha'ari
cya	I	Nopala Chatino
cyb	I	Cayubaba
cym	I	Welsh
cyo	I	Cuyonon
czh	I	Huizhou Chinese
czk	I	Knaanic
czn	I	Zenzontepec Chatino
czo	I	Min Zhong Chinese
czt	I	Zotung Chin
daa	I	Dangaléat
dac	I	Dambi
dad	I	Marik
dae	I	Duupa
dag	I	Dagbani
dah	I	Gwahatike
dai	I	Day
daj	I	Dar Fur Daju
dak	I	Dakota
dal	I	Dahalo
dam	I	Damakawa
dan	I	Danish
dao	I	Daai Chin
daq	I	Dandami Maria
dar	I	Dargwa
das	I	Daho-Doo
dau	I	Dar Sila Daju
dav	I	Taita
daw	I	Davawenyo
dax	I	Dayi
daz	I	Moi-Wadea
dba	I	Bangime
dbb	I	Deno
dbd	I	Dadiya
dbe	I	Dabe
dbf	I	Edopi
dbg	I	Dogul Dom Dogon
dbi	I	Doka
dbj	I	Ida'an
dbl	I	Dyirbal
dbm	I	Duguri
dbn	I	Duriankere
dbo	I	Dulbu
dbp	I	Duwai
dbq	I	Daba
dbr	I	Dabarre
dbt	I	Ben Tey Dogon
dbu	I	Bondum Dom Dogon
dbv	I	Dungu
dbw	I	Bankan Tey Dogon
dby	I	Dibiyaso
dcc	I	Deccan
dcr	I	Negerhollands
dda	I	Dadi Dadi
ddd	I	Dongotono
dde	I	Doondo
ddg	I	Fataluku
ddi	I	West Goodenough
ddj	I	Jaru
ddn	I	Dendi (Benin)
ddo	I	Dido
ddr	I	Dhudhuroa
dds	I	Donno So Dogon
ddw	I	Dawera-Daweloor
dec	I	Dagik
ded	I	Dedua
dee	I	Dewoin
def	I	Dezfuli
deg	I	Degema
deh	I	Dehwari
dei	I	Demisa
del	M	Delaware
dem	I	Dem
den	M	Slave (Athapascan)
dep	I	Pidgin Delaware
deq	I	Dendi (Central African Republic)
der	I	Deori
des	I	Desano
deu	I	German
dev	I	Domung
dez	I	Dengese
dga	I	Southern Dagaare
dgb	I	Bunoge Dogon
dgc	I	Casiguran Dumagat Agta
dgd	I	Dagaari Dioula
dge	I	Degenan
dgg	I	Doga
dgh	I	Dghwede
dgi	I	Northern Dagara
dgk	I	Dagba
dgl	I	Andaandi
dgn	I	Dagoman
dgo	I	Dogri (individual language)
dgr	I	Tlicho
dgs	I	Dogoso
dgt	I	Ndra'ngith
dgw	I	Daungwurrung
dgx	I	Doghoro
dgz	I	Daga
dhd	I	Dhundari
dhg	I	Dhangu-Djangu
dhi	I	Dhimal
dhl	I	Dhalandji
dhm	I	Zemba
dhn	I	Dhanki
dho	I	Dhodia
dhr	I	Dhargari
dhs	I	Dhaiso
dhu	I	Dhurga
dhv	I	Dehu
dhw	I	Dhanwar (Nepal)
dhx	I	Dhungaloo
dia	I	Dia
dib	I	South Central Dinka
dic	I	Lakota Dida
did	I	Didinga
dif	I	Dieri
dig	I	Digo
dih	I	Kumiai
dii	I	Dimbong
dij	I	Dai
dik	I	Southwestern Dinka
dil	I	Dilling
dim	I	Dime
din	M	Dinka
dio	I	Dibo
dip	I	Northeastern Dinka
diq	I	Dimli (individual language)
dir	I	Dirim
dis	I	Dimasa
diu	I	Diriku
div	I	Divehi
diw	I	Northwestern Dinka
dix	I	Dixon Reef
diy	I	Diuwe
diz	I	Ding
dja	I	Djadjawurrung
djb	I	Djinba
djc	I	Dar Daju Daju
djd	I	Djamindjung
dje	I	Zarma
djf	I	Djangun
dji	I	Djinang
djj	I	Djeebbana
djk	I	Eastern Maroon Creole
djm	I	Jamsay Dogon
djn	I	Jawoyn
djo	I	Jangkang
djr	I	Djambarrpuyngu
dju	I	Kapriman
djw	I	Djawi
dka	I	Dakpakha
dkg	I	Kadung
dkk	I	Dakka
dkr	I	Kuijau
dks	I	Southeastern Dinka
dkx	I	Mazagway
dlg	I	Dolgan
dlk	I	Dahalik
dlm	I	Dalmatian
dln	I	Darlong
dma	I	Duma
dmb	I	Mombo Dogon
dmc	I	Gavak
dmd	I	Madhi Madhi
dme	I	Dugwor
dmf	I	Medefaidrin
dmg	I	Upper Kinabatangan
dmk	I	Domaaki
dml	I	Dameli
dmm	I	Dama
dmo	I	Kemedzung
dmr	I	East Damar
dms	I	Dampelas
dmu	I	Dubu
dmv	I	Dumpas
dmw	I	Mudburra
dmx	I	Dema
dmy	I	Demta
dna	I	Upper Grand Valley Dani
dnd	I	Daonda
dne	I	Ndendeule
dng	I	Dungan
dni	I	Lower Grand Valley Dani
dnj	I	Dan
dnk	I	Dengka
dnn	I	Dzùùngoo
dno	I	Ndrulo
dnr	I	Danaru
dnt	I	Mid Grand Valley Dani
dnu	I	Danau
dnv	I	Danu
dnw	I	Western Dani
dny	I	Dení
doa	I	Dom
dob	I	Dobu
doc	I	Northern Dong
doe	I	Doe
dof	I	Domu
doh	I	Dong
doi	M	Dogri (macrolanguage)
dok	I	Dondo
dol	I	Doso
don	I	Toura (Papua New Guinea)
doo	I	Dongo
dop	I	Lukpa
doq	I	Dominican Sign Language
dor	I	Dori'o
dos	I	Dogosé
dot	I	Dass
dov	I	Dombe
dow	I	Doyayo
dox	I	Bussa
doy	I	Dompo
doz	I	Dorze
dpp	I	Papar
drb	I	Dair
drc	I	Minderico
drd	I	Darmiya
dre	I	Dolpo
drg	I	Rungus
dri	I	C'Lela
drl	I	Paakantyi
drn	I	West Damar
dro	I	Daro-Matu Melanau
drq	I	Dura
drs	I	Gedeo
drt	I	Drents
dru	I	Rukai
dry	I	Darai
dsb	I	Lower Sorbian
dse	I	Dutch Sign Language
dsh	I	Daasanach
dsi	I	Disa
dsk	I	Dokshi
dsl	I	Danish Sign Language
dsn	I	Dusner
dso	I	Desiya
dsq	I	Tadaksahak
dsz	I	Mardin Sign Language
dta	I	Daur
dtb	I	Labuk-Kinabatangan Kadazan
dtd	I	Ditidaht
dth	I	Adithinngithigh
dti	I	Ana Tinga Dogon
dtk	I	Tene Kan Dogon
dtm	I	Tomo Kan Dogon
dtn	I	Daatsʼíin
dto	I	Tommo So Dogon
dtp	I	Kadazan Dusun
dtr	I	Lotud
dts	I	Toro So Dogon
dtt	I	Toro Tegu Dogon
dtu	I	Tebul Ure Dogon
dty	I	Dotyali
dua	I	Duala
dub	I	Dubli
duc	I	Duna
due	I	Umiray Dumaget Agta
duf	I	Dumbea
dug	I	Duruma
duh	I	Dungra Bhil
dui	I	Dumun
duk	I	Uyajitaya
dul	I	Alabat Island Agta
dum	I	Middle Dutch (ca. 1050-1350)
dun	I	Dusun Deyah
duo	I	Dupaninan Agta
dup	I	Duano
duq	I	Dusun Malang
dur	I	Dii
dus	I	Dumi
duu	I	Drung
duv	I	Duvle
duw	I	Dusun Witu
dux	I	Duungooma
duy	I	Dicamay Agta
duz	I	Duli-Gey
dva	I	Duau
dwa	I	Diri
dwk	I	Dawik Kui
dwr	I	Dawro
dws	I	Dutton World Speedwords
dwu	I	Dhuwal
dww	I	Dawawa
dwy	I	Dhuwaya
dwz	I	Dewas Rai
dya	I	Dyan
dyb	I	Dyaberdyaber
dyd	I	Dyugun
dyg	I	Villa Viciosa Agta
dyi	I	Djimini Senoufo
dym	I	Yanda Dom Dogon
dyn	I	Dyangadi
dyo	I	Jola-Fonyi
dyr	I	Dyarim
dyu	I	Dyula
dyy	I	Djabugay
dza	I	Tunzu
dzd	I	Daza
dze	I	Djiwarli
dzg	I	Dazaga
dzl	I	Dzalakha
dzn	I	Dzando
dzo	I	Dzongkha
eaa	I	Karenggapa
ebc	I	Beginci
ebg	I	Ebughu
ebk	I	Eastern Bontok
ebo	I	Teke-Ebo
ebr	I	Ebrié
ebu	I	Embu
ecr	I	Eteocretan
ecs	I	Ecuadorian Sign Language
ecy	I	Eteocypriot
eee	I	E
efa	I	Efai
efe	I	Efe
efi	I	Efik
ega	I	Ega
egl	I	Emilian
egm	I	Benamanga
ego	I	Eggon
egy	I	Egyptian (Ancient)
ehs	I	Miyakubo Sign Language
ehu	I	Ehueun
eip	I	Eipomek
eit	I	Eitiep
eiv	I	Askopan
eja	I	Ejamat
eka	I	Ekajuk
eke	I	Ekit
ekg	I	Ekari
eki	I	Eki
ekk	I	Standard Estonian
ekl	I	Kol (Bangladesh)
ekm	I	Elip
eko	I	Koti
ekp	I	Ekpeye
ekr	I	Yace
eky	I	Eastern Kayah
ele	I	Elepi
elh	I	El Hugeirat
eli	I	Nding
elk	I	Elkei
ell	I	Modern Greek (1453-)
elm	I	Eleme
elo	I	El Molo
elu	I	Elu
elx	I	Elamite
ema	I	Emai-Iuleha-Ora
emb	I	Embaloh
eme	I	Emerillon
emg	I	Eastern Meohang
emi	I	Mussau-Emira
emk	I	Eastern Maninkakan
emm	I	Mamulique
emn	I	Eman
emp	I	Northern Emberá
emq	I	Eastern Minyag
ems	I	Pacific Gulf Yupik
emu	I	Eastern Muria
emw	I	Emplawas
emx	I	Erromintxela
emy	I	Epigraphic Mayan
emz	I	Mbessa
ena	I	Apali
enb	I	Markweeta
enc	I	En
end	I	Ende
enf	I	Forest Enets
eng	I	English
enh	I	Tundra Enets
enl	I	Enlhet
enm	I	Middle English (1100-1500)
enn	I	Engenni
eno	I	Enggano
enq	I	Enga
enr	I	Emumu
enu	I	Enu
env	I	Enwan (Edo State)
enw	I	Enwan (Akwa Ibom State)
enx	I	Enxet
eot	I	Beti (Côte d'Ivoire)
epi	I	Epie
epo	I	Esperanto
era	I	Eravallan
erg	I	Sie
erh	I	Eruwa
eri	I	Ogea
erk	I	South Efate
ero	I	Horpa
err	I	Erre
ers	I	Ersu
ert	I	Eritai
erw	I	Erokwanas
ese	I	Ese Ejja
esg	I	Aheri Gondi
esh	I	Eshtehardi
esi	I	North Alaskan Inupiatun
esk	I	Northwest Alaska Inupiatun
esl	I	Egypt Sign Language
esm	I	Esuma
esn	I	Salvadoran Sign Language
eso	I	Estonian Sign Language
esq	I	Esselen
ess	I	Central Siberian Yupik
est	M	Estonian
esu	I	Central Yupik
esy	I	Eskayan
etb	I	Etebi
etc	I	Etchemin
eth	I	Ethiopian Sign Language
etn	I	Eton (Vanuatu)
eto	I	Eton (Cameroon)
etr	I	Edolo
ets	I	Yekhee
ett	I	Etruscan
etu	I	Ejagham
etx	I	Eten
etz	I	Semimi
eud	I	Eudeve
eus	I	Basque
eve	I	Even
evh	I	Uvbie
evn	I	Evenki
ewe	I	Ewe
ewo	I	Ewondo
ext	I	Extremaduran
eya	I	Eyak
eyo	I	Keiyo
eza	I	Ezaa
eze	I	Uzekwe
faa	I	Fasu
fab	I	Fa d'Ambu
fad	I	Wagi
faf	I	Fagani
fag	I	Finongan
fah	I	Baissa Fali
fai	I	Faiwol
faj	I	Faita
fak	I	Fang (Cameroon)
fal	I	South Fali
fam	I	Fam
fan	I	Fang (Equatorial Guinea)
fao	I	Faroese
fap	I	Paloor
far	I	Fataleka
fas	M	Persian
fat	I	Fanti
fau	I	Fayu
fax	I	Fala
fay	I	Southwestern Fars
faz	I	Northwestern Fars
fbl	I	West Albay Bikol
fcs	I	Quebec Sign Language
fer	I	Feroge
ffi	I	Foia Foia
ffm	I	Maasina Fulfulde
fgr	I	Fongoro
fia	I	Nobiin
fie	I	Fyer
fif	I	Faifi
fij	I	Fijian
fil	I	Filipino
fin	I	Finnish
fip	I	Fipa
fir	I	Firan
fit	I	Tornedalen Finnish
fiw	I	Fiwaga
fkk	I	Kirya-Konzəl
fkv	I	Kven Finnish
fla	I	Kalispel-Pend d'Oreille
flh	I	Foau
fli	I	Fali
fll	I	North Fali
fln	I	Flinders Island
flr	I	Fuliiru
fly	I	Flaaitaal
fmp	I	Fe'fe'
fmu	I	Far Western Muria
fnb	I	Fanbak
fng	I	Fanagalo
fni	I	Fania
fod	I	Foodo
foi	I	Foi
fom	I	Foma
fon	I	Fon
for	I	Fore
fos	I	Siraya
fpe	I	Fernando Po Creole English
fqs	I	Fas
fra	I	French
frc	I	Cajun French
frd	I	Fordata
frk	I	Frankish
frm	I	Middle French (ca. 1400-1600)
fro	I	Old French (842-ca. 1400)
frp	I	Arpitan
frq	I	Forak
frr	I	Northern Frisian
frs	I	Eastern Frisian
frt	I	Fortsenal
fry	I	Western Frisian
fse	I	Finnish Sign Language
fsl	I	French Sign Language
fss	I	Finland-Swedish Sign Language
fub	I	Adamawa Fulfulde
fuc	I	Pulaar
fud	I	East Futuna
fue	I	Borgu Fulfulde
fuf	I	Pular
fuh	I	Western Niger Fulfulde
fui	I	Bagirmi Fulfulde
fuj	I	Ko
ful	M	Fulah
fum	I	Fum
fun	I	Fulniô
fuq	I	Central-Eastern Niger Fulfulde
fur	I	Friulian
fut	I	Futuna-Aniwa
fuu	I	Furu
fuv	I	Nigerian Fulfulde
fuy	I	Fuyug
fvr	I	Fur
fwa	I	Fwâi
fwe	I	Fwe
gaa	I	Ga
gab	I	Gabri
gac	I	Mixed Great Andamanese
gad	I	Gaddang
gae	I	Guarequena
gaf	I	Gende
gag	I	Gagauz
gah	I	Alekano
gai	I	Borei
gaj	I	Gadsup
gak	I	Gamkonora
gal	I	Galolen
gam	I	Kandawo
gan	I	Gan Chinese
gao	I	Gants
gap	I	Gal
gaq	I	Gata'
gar	I	Galeya
gas	I	Adiwasi Garasia
gat	I	Kenati
gau	I	Mudhili Gadaba
gaw	I	Nobonob
gax	I	Borana-Arsi-Guji Oromo
gay	I	Gayo
gaz	I	West Central Oromo
gba	M	Gbaya (Central African Republic)
gbb	I	Kaytetye
gbd	I	Karajarri
gbe	I	Niksek
gbf	I	Gaikundi
gbg	I	Gbanziri
gbh	I	Defi Gbe
gbi	I	Galela
gbj	I	Bodo Gadaba
gbk	I	Gaddi
gbl	I	Gamit
gbm	I	Garhwali
gbn	I	Mo'da
gbo	I	Northern Grebo
gbp	I	Gbaya-Bossangoa
gbq	I	Gbaya-Bozoum
gbr	I	Gbagyi
gbs	I	Gbesi Gbe
gbu	I	Gagadu
gbv	I	Gbanu
gbw	I	Gabi-Gabi
gbx	I	Eastern Xwla Gbe
gby	I	Gbari
gbz	I	Zoroastrian Dari
gcc	I	Mali
gcd	I	Ganggalida
gce	I	Galice
gcf	I	Guadeloupean Creole French
gcl	I	Grenadian Creole English
gcn	I	Gaina
gcr	I	Guianese Creole French
gct	I	Colonia Tovar German
gda	I	Gade Lohar
gdb	I	Pottangi Ollar Gadaba
gdc	I	Gugu Badhun
gdd	I	Gedaged
gde	I	Gude
gdf	I	Guduf-Gava
gdg	I	Ga'dang
gdh	I	Gadjerawang
gdi	I	Gundi
gdj	I	Gurdjar
gdk	I	Gadang
gdl	I	Dirasha
gdm	I	Laal
gdn	I	Umanakaina
gdo	I	Ghodoberi
gdq	I	Mehri
gdr	I	Wipi
gds	I	Ghandruk Sign Language
gdt	I	Kungardutyi
gdu	I	Gudu
gdx	I	Godwari
gea	I	Geruma
geb	I	Kire
gec	I	Gboloo Grebo
ged	I	Gade
gef	I	Gerai
geg	I	Gengle
geh	I	Hutterite German
gei	I	Gebe
gej	I	Gen
gek	I	Ywom
gel	I	ut-Ma'in
geq	I	Geme
ges	I	Geser-Gorom
gev	I	Eviya
gew	I	Gera
gex	I	Garre
gey	I	Enya
gez	I	Geez
gfk	I	Patpatar
gft	I	Gafat
gga	I	Gao
ggb	I	Gbii
ggd	I	Gugadj
gge	I	Gurr-goni
ggg	I	Gurgula
ggk	I	Kungarakany
ggl	I	Ganglau
ggt	I	Gitua
ggu	I	Gagu
ggw	I	Gogodala
gha	I	Ghadamès
ghc	I	Hiberno-Scottish Gaelic
ghe	I	Southern Ghale
ghh	I	Northern Ghale
ghk	I	Geko Karen
ghl	I	Ghulfan
ghn	I	Ghanongga
gho	I	Ghomara
ghr	I	Ghera
ghs	I	Guhu-Samane
ght	I	Kuke
gia	I	Kija
gib	I	Gibanawa
gic	I	Gail
gid	I	Gidar
gie	I	Gaɓogbo
gig	I	Goaria
gih	I	Githabul
gii	I	Girirra
gil	I	Gilbertese
gim	I	Gimi (Eastern Highlands)
gin	I	Hinukh
gip	I	Gimi (West New Britain)
giq	I	Green Gelao
gir	I	Red Gelao
gis	I	North Giziga
git	I	Gitxsan
giu	I	Mulao
giw	I	White Gelao
gix	I	Gilima
giy	I	Giyug
giz	I	South Giziga
gjk	I	Kachi Koli
gjm	I	Gunditjmara
gjn	I	Gonja
gjr	I	Gurindji Kriol
gju	I	Gujari
gka	I	Guya
gkd	I	Magɨ (Madang Province)
gke	I	Ndai
gkn	I	Gokana
gko	I	Kok-Nar
gkp	I	Guinea Kpelle
gku	I	ǂUngkue
gla	I	Scottish Gaelic
glb	I	Belning
glc	I	Bon Gula
gld	I	Nanai
gle	I	Irish
glg	I	Galician
glh	I	Northwest Pashai
glj	I	Gula Iro
glk	I	Gilaki
gll	I	Garlali
glo	I	Galambu
glr	I	Glaro-Twabo
glu	I	Gula (Chad)
glv	I	Manx
glw	I	Glavda
gly	I	Gule
gma	I	Gambera
gmb	I	Gula'alaa
gmd	I	Mághdì
gmg	I	Magɨyi
gmh	I	Middle High German (ca. 1050-1500)
gml	I	Middle Low German
gmm	I	Gbaya-Mbodomo
gmn	I	Gimnime
gmr	I	Mirning
gmu	I	Gumalu
gmv	I	Gamo
gmx	I	Magoma
gmy	I	Mycenaean Greek
gmz	I	Mgbolizhia
gna	I	Kaansa
gnb	I	Gangte
gnc	I	Guanche
gnd	I	Zulgo-Gemzek
gne	I	Ganang
gng	I	Ngangam
gnh	I	Lere
gni	I	Gooniyandi
gnj	I	Ngen
gnk	I	ǁGana
gnl	I	Gangulu
gnm	I	Ginuman
gnn	I	Gumatj
gno	I	Northern Gondi
gnq	I	Gana
gnr	I	Gureng Gureng
gnt	I	Guntai
gnu	I	Gnau
gnw	I	Western Bolivian Guaraní
gnz	I	Ganzi
goa	I	Guro
gob	I	Playero
goc	I	Gorakor
god	I	Godié
goe	I	Gongduk
gof	I	Gofa
gog	I	Gogo
goh	I	Old High German (ca. 750-1050)
goi	I	Gobasi
goj	I	Gowlan
gok	I	Gowli
gol	I	Gola
gom	I	Goan Konkani
gon	M	Gondi
goo	I	Gone Dau
gop	I	Yeretuar
goq	I	Gorap
gor	I	Gorontalo
gos	I	Gronings
got	I	Gothic
gou	I	Gavar
gov	I	Goo
gow	I	Gorowa
gox	I	Gobu
goy	I	Goundo
goz	I	Gozarkhani
gpa	I	Gupa-Abawa
gpe	I	Ghanaian Pidgin English
gpn	I	Taiap
gqa	I	Ga'anda
gqi	I	Guiqiong
gqn	I	Guana (Brazil)
gqr	I	Gor
gqu	I	Qau
gra	I	Rajput Garasia
grb	M	Grebo
grc	I	Ancient Greek (to 1453)
grd	I	Guruntum-Mbaaru
grg	I	Madi
grh	I	Gbiri-Niragu
gri	I	Ghari
grj	I	Southern Grebo
grm	I	Kota Marudu Talantang
grn	M	Guarani
gro	I	Groma
grq	I	Gorovu
grr	I	Taznatit
grs	I	Gresi
grt	I	Garo
gru	I	Kistane
grv	I	Central Grebo
grw	I	Gweda
grx	I	Guriaso
gry	I	Barclayville Grebo
grz	I	Guramalum
gse	I	Ghanaian Sign Language
gsg	I	German Sign Language
gsl	I	Gusilay
gsm	I	Guatemalan Sign Language
gsn	I	Nema
gso	I	Southwest Gbaya
gsp	I	Wasembo
gss	I	Greek Sign Language
gsw	I	Swiss German
gta	I	Guató
gtu	I	Aghu-Tharnggala
gua	I	Shiki
gub	I	Guajajára
guc	I	Wayuu
gud	I	Yocoboué Dida
gue	I	Gurindji
guf	I	Gupapuyngu
gug	I	Paraguayan Guaraní
guh	I	Guahibo
gui	I	Eastern Bolivian Guaraní
guj	I	Gujarati
guk	I	Gumuz
gul	I	Sea Island Creole English
gum	I	Guambiano
gun	I	Mbyá Guaraní
guo	I	Guayabero
gup	I	Gunwinggu
guq	I	Aché
gur	I	Farefare
gus	I	Guinean Sign Language
gut	I	Maléku Jaíka
guu	I	Yanomamö
guw	I	Gun
gux	I	Gourmanchéma
guz	I	Gusii
gva	I	Guana (Paraguay)
gvc	I	Guanano
gve	I	Duwet
gvf	I	Golin
gvj	I	Guajá
gvl	I	Gulay
gvm	I	Gurmana
gvn	I	Kuku-Yalanji
gvo	I	Gavião Do Jiparaná
gvp	I	Pará Gavião
gvr	I	Gurung
gvs	I	Gumawana
gvy	I	Guyani
gwa	I	Mbato
gwb	I	Gwa
gwc	I	Gawri
gwd	I	Gawwada
gwe	I	Gweno
gwf	I	Gowro
gwg	I	Moo
gwi	I	Gwichʼin
gwj	I	ǀGwi
gwm	I	Awngthim
gwn	I	Gwandara
gwr	I	Gwere
gwt	I	Gawar-Bati
gwu	I	Guwamu
gww	I	Kwini
gwx	I	Gua
gxx	I	Wè Southern
gya	I	Northwest Gbaya
gyb	I	Garus
gyd	I	Kayardild
gye	I	Gyem
gyf	I	Gungabula
gyg	I	Gbayi
gyi	I	Gyele
gyl	I	Gayil
gym	I	Ngäbere
gyn	I	Guyanese Creole English
gyo	I	Gyalsumdo
gyr	I	Guarayu
gyy	I	Gunya
gyz	I	Geji
gza	I	Ganza
gzi	I	Gazi
gzn	I	Gane
haa	I	Hän
hab	I	Hanoi Sign Language
hac	I	Gurani
had	I	Hatam
hae	I	Eastern Oromo
haf	I	Haiphong Sign Language
hag	I	Hanga
hah	I	Hahon
hai	M	Haida
haj	I	Hajong
hak	I	Hakka Chinese
hal	I	Halang
ham	I	Hewa
han	I	Hangaza
hao	I	Hakö
hap	I	Hupla
haq	I	Ha
har	I	Harari
has	I	Haisla
hat	I	Haitian
hau	I	Hausa
hav	I	Havu
haw	I	Hawaiian
hax	I	Southern Haida
hay	I	Haya
haz	I	Hazaragi
hba	I	Hamba
hbb	I	Huba
hbn	I	Heiban
hbo	I	Ancient Hebrew
hbs	M	Serbo-Croatian
hbu	I	Habu
hca	I	Andaman Creole Hindi
hch	I	Huichol
hdn	I	Northern Haida
hds	I	Honduras Sign Language
hdy	I	Hadiyya
hea	I	Northern Qiandong Miao
heb	I	Hebrew
hed	I	Herdé
heg	I	Helong
heh	I	Hehe
hei	I	Heiltsuk
hem	I	Hemba
her	I	Herero
hgm	I	Haiǁom
hgw	I	Haigwai
hhi	I	Hoia Hoia
hhr	I	Kerak
hhy	I	Hoyahoya
hia	I	Lamang
hib	I	Hibito
hid	I	Hidatsa
hif	I	Fiji Hindi
hig	I	Kamwe
hih	I	Pamosu
hii	I	Hinduri
hij	I	Hijuk
hik	I	Seit-Kaitetu
hil	I	Hiligaynon
hin	I	Hindi
hio	I	Tsoa
hir	I	Himarimã
hit	I	Hittite
hiw	I	Hiw
hix	I	Hixkaryána
hji	I	Haji
hka	I	Kahe
hke	I	Hunde
hkh	I	Khah
hkk	I	Hunjara-Kaina Ke
hkn	I	Mel-Khaonh
hks	I	Hong Kong Sign Language
hla	I	Halia
hlb	I	Halbi
hld	I	Halang Doan
hle	I	Hlersu
hlt	I	Matu Chin
hlu	I	Hieroglyphic Luwian
hma	I	Southern Mashan Hmong
hmb	I	Humburi Senni Songhay
hmc	I	Central Huishui Hmong
hmd	I	Large Flowery Miao
hme	I	Eastern Huishui Hmong
hmf	I	Hmong Don
hmg	I	Southwestern Guiyang Hmong
hmh	I	Southwestern Huishui Hmong
hmi	I	Northern Huishui Hmong
hmj	I	Ge
hmk	I	Maek
hml	I	Luopohe Hmong
hmm	I	Central Mashan Hmong
hmn	M	Hmong
hmo	I	Hiri Motu
hmp	I	Northern Mashan Hmong
hmq	I	Eastern Qiandong Miao
hmr	I	Hmar
hms	I	Southern Qiandong Miao
hmt	I	Hamtai
hmu	I	Hamap
hmv	I	Hmong Dô
hmw	I	Western Mashan Hmong
hmy	I	Southern Guiyang Hmong
hmz	I	Hmong Shua
hna	I	Mina (Cameroon)
hnd	I	Southern Hindko
hne	I	Chhattisgarhi
hng	I	Hungu
hnh	I	ǁAni
hni	I	Hani
hnj	I	Hmong Njua
hnm	I	Hainanese
hnn	I	Hanunoo
hno	I	Northern Hindko
hns	I	Caribbean Hindustani
hnu	I	Hung
hoa	I	Hoava
hob	I	Mari (Madang Province)
hoc	I	Ho
hod	I	Holma
hoe	I	Horom
hoh	I	Hobyót
hoi	I	Holikachuk
hoj	I	Hadothi
hol	I	Holu
hom	I	Homa
hoo	I	Holoholo
hop	I	Hopi
hor	I	Horo
hos	I	Ho Chi Minh City Sign Language
hot	I	Hote
hov	I	Hovongan
how	I	Honi
hoy	I	Holiya
hoz	I	Hozo
hpo	I	Hpon
hps	I	Hawai'i Sign Language (HSL)
hra	I	Hrangkhol
hrc	I	Niwer Mil
hre	I	Hre
hrk	I	Haruku
hrm	I	Horned Miao
hro	I	Haroi
hrp	I	Nhirrpi
hrt	I	Hértevin
hru	I	Hruso
hrv	I	Croatian
hrw	I	Warwar Feni
hrx	I	Hunsrik
hrz	I	Harzani
hsb	I	Upper Sorbian
hsh	I	Hungarian Sign Language
hsl	I	Hausa Sign Language
hsn	I	Xiang Chinese
hss	I	Harsusi
hti	I	Hoti
hto	I	Minica Huitoto
hts	I	Hadza
htu	I	Hitu
htx	I	Middle Hittite
hub	I	Huambisa
huc	I	ǂHua
hud	I	Huaulu
hue	I	San Francisco Del Mar Huave
huf	I	Humene
hug	I	Huachipaeri
huh	I	Huilliche
hui	I	Huli
huj	I	Northern Guiyang Hmong
huk	I	Hulung
hul	I	Hula
hum	I	Hungana
hun	I	Hungarian
huo	I	Hu
hup	I	Hupa
huq	I	Tsat
hur	I	Halkomelem
hus	I	Huastec
hut	I	Humla
huu	I	Murui Huitoto
huv	I	San Mateo Del Mar Huave
huw	I	Hukumina
hux	I	Nüpode Huitoto
huy	I	Hulaulá
huz	I	Hunzib
hvc	I	Haitian Vodoun Culture Language
hve	I	San Dionisio Del Mar Huave
hvk	I	Haveke
hvn	I	Sabu
hvv	I	Santa María Del Mar Huave
hwa	I	Wané
hwc	I	Hawai'i Creole English
hwo	I	Hwana
hya	I	Hya
hye	I	Armenian
hyw	I	Western Armenian
iai	I	Iaai
ian	I	Iatmul
iar	I	Purari
iba	I	Iban
ibb	I	Ibibio
ibd	I	Iwaidja
ibe	I	Akpes
ibg	I	Ibanag
ibh	I	Bih
ibl	I	Ibaloi
ibm	I	Agoi
ibn	I	Ibino
ibo	I	Igbo
ibr	I	Ibuoro
ibu	I	Ibu
iby	I	Ibani
ica	I	Ede Ica
ich	I	Etkywan
icl	I	Icelandic Sign Language
icr	I	Islander Creole English
ida	I	Idakho-Isukha-Tiriki
idb	I	Indo-Portuguese
idc	I	Idon
idd	I	Ede Idaca
ide	I	Idere
idi	I	Idi
ido	I	Ido
idr	I	Indri
ids	I	Idesa
idt	I	Idaté
idu	I	Idoma
ifa	I	Amganad Ifugao
ifb	I	Batad Ifugao
ife	I	Ifè
iff	I	Ifo
ifk	I	Tuwali Ifugao
ifm	I	Teke-Fuumu
ifu	I	Mayoyao Ifugao
ify	I	Keley-I Kallahan
igb	I	Ebira
ige	I	Igede
igg	I	Igana
igl	I	Igala
igm	I	Kanggape
ign	I	Ignaciano
igo	I	Isebe
igs	I	Interglossa
igw	I	Igwe
ihb	I	Iha Based Pidgin
ihi	I	Ihievbe
ihp	I	Iha
ihw	I	Bidhawal
iii	I	Sichuan Yi
iin	I	Thiin
ijc	I	Izon
ije	I	Biseni
ijj	I	Ede Ije
ijn	I	Kalabari
ijs	I	Southeast Ijo
ike	I	Eastern Canadian Inuktitut
ikh	I	Ikhin-Arokho
iki	I	Iko
ikk	I	Ika
ikl	I	Ikulu
iko	I	Olulumo-Ikom
ikp	I	Ikpeshi
ikr	I	Ikaranggal
iks	I	Inuit Sign Language
ikt	I	Inuinnaqtun
iku	M	Inuktitut
ikv	I	Iku-Gora-Ankwa
ikw	I	Ikwere
ikx	I	Ik
ikz	I	Ikizu
ila	I	Ile Ape
ilb	I	Ila
ile	I	Interlingue
ilg	I	Garig-Ilgar
ili	I	Ili Turki
ilk	I	Ilongot
ilm	I	Iranun (Malaysia)
ilo	I	Iloko
ilp	I	Iranun (Philippines)
ils	I	International Sign
ilu	I	Ili'uun
ilv	I	Ilue
ima	I	Mala Malasar
imi	I	Anamgura
iml	I	Miluk
imn	I	Imonda
imo	I	Imbongu
imr	I	Imroing
ims	I	Marsian
imt	I	Imotong
imy	I	Milyan
ina	I	Interlingua (International Auxiliary Language Association)
inb	I	Inga
ind	I	Indonesian
ing	I	Degexit'an
inh	I	Ingush
inj	I	Jungle Inga
inl	I	Indonesian Sign Language
inm	I	Minaean
inn	I	Isinai
ino	I	Inoke-Yate
inp	I	Iñapari
ins	I	Indian Sign Language
int	I	Intha
inz	I	Ineseño
ior	I	Inor
iou	I	Tuma-Irumu
iow	I	Iowa-Oto
ipi	I	Ipili
ipk	M	Inupiaq
ipo	I	Ipiko
iqu	I	Iquito
iqw	I	Ikwo
ire	I	Iresim
irh	I	Irarutu
iri	I	Rigwe
irk	I	Iraqw
irn	I	Irántxe
irr	I	Ir
iru	I	Irula
irx	I	Kamberau
iry	I	Iraya
isa	I	Isabi
isc	I	Isconahua
isd	I	Isnag
ise	I	Italian Sign Language
isg	I	Irish Sign Language
ish	I	Esan
isi	I	Nkem-Nkum
isk	I	Ishkashimi
isl	I	Icelandic
ism	I	Masimasi
isn	I	Isanzu
iso	I	Isoko
isr	I	Israeli Sign Language
ist	I	Istriot
isu	I	Isu (Menchum Division)
isv	I	Interslavic
ita	I	Italian
itb	I	Binongan Itneg
itd	I	Southern Tidung
ite	I	Itene
iti	I	Inlaod Itneg
itk	I	Judeo-Italian
itl	I	Itelmen
itm	I	Itu Mbon Uzo
ito	I	Itonama
itr	I	Iteri
its	I	Isekiri
itt	I	Maeng Itneg
itv	I	Itawit
itw	I	Ito
itx	I	Itik
ity	I	Moyadan Itneg
itz	I	Itzá
ium	I	Iu Mien
ivb	I	Ibatan
ivv	I	Ivatan
iwk	I	I-Wak
iwm	I	Iwam
iwo	I	Iwur
iws	I	Sepik Iwam
ixc	I	Ixcatec
ixl	I	Ixil
iya	I	Iyayu
iyo	I	Mesaka
iyx	I	Yaka (Congo)
izh	I	Ingrian
izm	I	Kizamani
izr	I	Izere
izz	I	Izii
jaa	I	Jamamadí
jab	I	Hyam
jac	I	Popti'
jad	I	Jahanka
jae	I	Yabem
jaf	I	Jara
jah	I	Jah Hut
jaj	I	Zazao
jak	I	Jakun
jal	I	Yalahatan
jam	I	Jamaican Creole English
jan	I	Jandai
jao	I	Yanyuwa
jaq	I	Yaqay
jas	I	New Caledonian Javanese
jat	I	Jakati
jau	I	Yaur
jav	I	Javanese
jax	I	Jambi Malay
jay	I	Yan-nhangu
jaz	I	Jawe
jbe	I	Judeo-Berber
jbi	I	Badjiri
jbj	I	Arandai
jbk	I	Barikewa
jbm	I	Bijim
jbn	I	Nafusi
jbo	I	Lojban
jbr	I	Jofotek-Bromnya
jbt	I	Jabutí
jbu	I	Jukun Takum
jbw	I	Yawijibaya
jcs	I	Jamaican Country Sign Language
jct	I	Krymchak
jda	I	Jad
jdg	I	Jadgali
jdt	I	Judeo-Tat
jeb	I	Jebero
jee	I	Jerung
jeh	I	Jeh
jei	I	Yei
jek	I	Jeri Kuo
jel	I	Yelmek
jen	I	Dza
jer	I	Jere
jet	I	Manem
jeu	I	Jonkor Bourmataguil
jgb	I	Ngbee
jge	I	Judeo-Georgian
jgk	I	Gwak
jgo	I	Ngomba
jhi	I	Jehai
jhs	I	Jhankot Sign Language
jia	I	Jina
jib	I	Jibu
jic	I	Tol
jid	I	Bu (Kaduna State)
jie	I	Jilbe
jig	I	Jingulu
jih	I	sTodsde
jii	I	Jiiddu
jil	I	Jilim
jim	I	Jimi (Cameroon)
jio	I	Jiamao
jiq	I	Guanyinqiao
jit	I	Jita
jiu	I	Youle Jinuo
jiv	I	Shuar
jiy	I	Buyuan Jinuo
jje	I	Jejueo
jjr	I	Bankal
jka	I	Kaera
jkm	I	Mobwa Karen
jko	I	Kubo
jkp	I	Paku Karen
jkr	I	Koro (India)
jks	I	Amami Koniya Sign Language
jku	I	Labir
jle	I	Ngile
jls	I	Jamaican Sign Language
jma	I	Dima
jmb	I	Zumbun
jmc	I	Machame
jmd	I	Yamdena
jmi	I	Jimi (Nigeria)
jml	I	Jumli
jmn	I	Makuri Naga
jmr	I	Kamara
jms	I	Mashi (Nigeria)
jmw	I	Mouwase
jmx	I	Western Juxtlahuaca Mixtec
jna	I	Jangshung
jnd	I	Jandavra
jng	I	Yangman
jni	I	Janji
jnj	I	Yemsa
jnl	I	Rawat
jns	I	Jaunsari
job	I	Joba
jod	I	Wojenaka
jog	I	Jogi
jor	I	Jorá
jos	I	Jordanian Sign Language
jow	I	Jowulu
jpa	I	Jewish Palestinian Aramaic
jpn	I	Japanese
jpr	I	Judeo-Persian
jqr	I	Jaqaru
jra	I	Jarai
jrb	M	Judeo-Arabic
jrr	I	Jiru
jrt	I	Jakattoe
jru	I	Japrería
jsl	I	Japanese Sign Language
jua	I	Júma
jub	I	Wannu
juc	I	Jurchen
jud	I	Worodougou
juh	I	Hõne
jui	I	Ngadjuri
juk	I	Wapan
jul	I	Jirel
jum	I	Jumjum
jun	I	Juang
juo	I	Jiba
jup	I	Hupdë
jur	I	Jurúna
jus	I	Jumla Sign Language
jut	I	Jutish
juu	I	Ju
juw	I	Wãpha
juy	I	Juray
jvd	I	Javindo
jvn	I	Caribbean Javanese
jwi	I	Jwira-Pepesa
jya	I	Jiarong
jye	I	Judeo-Yemeni Arabic
jyy	I	Jaya
kaa	I	Kara-Kalpak
kab	I	Kabyle
kac	I	Kachin
kad	I	Adara
kae	I	Ketangalan
kaf	I	Katso
kag	I	Kajaman
kah	I	Kara (Central African Republic)
kai	I	Karekare
kaj	I	Jju
kak	I	Kalanguya
kal	I	Kalaallisut
kam	I	Kamba (Kenya)
kan	I	Kannada
kao	I	Xaasongaxango
kap	I	Bezhta
kaq	I	Capanahua
kas	I	Kashmiri
kat	I	Georgian
kau	M	Kanuri
kav	I	Katukína
kaw	I	Kawi
kax	I	Kao
kay	I	Kamayurá
kaz	I	Kazakh
kba	I	Kalarko
kbb	I	Kaxuiâna
kbc	I	Kadiwéu
kbd	I	Kabardian
kbe	I	Kanju
kbg	I	Khamba
kbh	I	Camsá
kbi	I	Kaptiau
kbj	I	Kari
kbk	I	Grass Koiari
kbl	I	Kanembu
kbm	I	Iwal
kbn	I	Kare (Central African Republic)
kbo	I	Keliko
kbp	I	Kabiyè
kbq	I	Kamano
kbr	I	Kafa
kbs	I	Kande
kbt	I	Abadi
kbu	I	Kabutra
kbv	I	Dera (Indonesia)
kbw	I	Kaiep
kbx	I	Ap Ma
kby	I	Manga Kanuri
kbz	I	Duhwa
kca	I	Khanty
kcb	I	Kawacha
kcc	I	Lubila
kcd	I	Ngkâlmpw Kanum
kce	I	Kaivi
kcf	I	Ukaan
kcg	I	Tyap
kch	I	Vono
kci	I	Ngyian
kcj	I	Kobiana
kck	I	Kalanga
kcl	I	Kela (Papua New Guinea)
kcm	I	Gula (Central African Republic)
kcn	I	Nubi
kco	I	Kinalakna
kcp	I	Kanga
kcq	I	Kamo
kcr	I	Katla
kcs	I	Koenoem
kct	I	Kaian
kcu	I	Kami (Tanzania)
kcv	I	Kete
kcw	I	Kabwari
kcx	I	Kachama-Ganjule
kcy	I	Korandje
kcz	I	Konongo
kda	I	Worimi
kdc	I	Kutu
kdd	I	Yankunytjatjara
kde	I	Makonde
kdf	I	Mamusi
kdg	I	Seba
kdh	I	Tem
kdi	I	Kumam
kdj	I	Karamojong
kdk	I	Numèè
kdl	I	Tsikimba
kdm	I	Kagoma
kdn	I	Kunda
kdp	I	Kaningdon-Nindem
kdq	I	Koch
kdr	I	Karaim
kdt	I	Kuy
kdu	I	Kadaru
kdw	I	Koneraw
kdx	I	Kam
kdy	I	Keder
kdz	I	Kwaja
kea	I	Kabuverdianu
keb	I	Kélé
kec	I	Keiga
ked	I	Kerewe
kee	I	Eastern Keres
kef	I	Kpessi
keg	I	Tese
keh	I	Keak
kei	I	Kei
kej	I	Kadar
kek	I	Kekchí
kel	I	Kela (Democratic Republic of Congo)
kem	I	Kemak
ken	I	Kenyang
keo	I	Kakwa
kep	I	Kaikadi
keq	I	Kamar
ker	I	Kera
kes	I	Kugbo
ket	I	Ket
keu	I	Akebu
kev	I	Kanikkaran
kew	I	West Kewa
kex	I	Kukna
key	I	Kupia
kez	I	Kukele
kfa	I	Kodava
kfb	I	Northwestern Kolami
kfc	I	Konda-Dora
kfd	I	Korra Koraga
kfe	I	Kota (India)
kff	I	Koya
kfg	I	Kudiya
kfh	I	Kurichiya
kfi	I	Kannada Kurumba
kfj	I	Kemiehua
kfk	I	Kinnauri
kfl	I	Kung
kfm	I	Khunsari
kfn	I	Kuk
kfo	I	Koro (Côte d'Ivoire)
kfp	I	Korwa
kfq	I	Korku
kfr	I	Kachhi
kfs	I	Bilaspuri
kft	I	Kanjari
kfu	I	Katkari
kfv	I	Kurmukar
kfw	I	Kharam Naga
kfx	I	Kullu Pahari
kfy	I	Kumaoni
kfz	I	Koromfé
kga	I	Koyaga
kgb	I	Kawe
kge	I	Komering
kgf	I	Kube
kgg	I	Kusunda
kgi	I	Selangor Sign Language
kgj	I	Gamale Kham
kgk	I	Kaiwá
kgl	I	Kunggari
kgn	I	Karingani
kgo	I	Krongo
kgp	I	Kaingang
kgq	I	Kamoro
kgr	I	Abun
kgs	I	Kumbainggar
kgt	I	Somyev
kgu	I	Kobol
kgv	I	Karas
kgw	I	Karon Dori
kgx	I	Kamaru
kgy	I	Kyerung
kha	I	Khasi
khb	I	Lü
khc	I	Tukang Besi North
khd	I	Bädi Kanum
khe	I	Korowai
khf	I	Khuen
khg	I	Khams Tibetan
khh	I	Kehu
khj	I	Kuturmi
khk	I	Halh Mongolian
khl	I	Lusi
khm	I	Khmer
khn	I	Khandesi
kho	I	Khotanese
khp	I	Kapori
khq	I	Koyra Chiini Songhay
khr	I	Kharia
khs	I	Kasua
kht	I	Khamti
khu	I	Nkhumbi
khv	I	Khvarshi
khw	I	Khowar
khx	I	Kanu
khy	I	Kele (Democratic Republic of Congo)
khz	I	Keapara
kia	I	Kim
kib	I	Koalib
kic	I	Kickapoo
kid	I	Koshin
kie	I	Kibet
kif	I	Eastern Parbate Kham
kig	I	Kimaama
kih	I	Kilmeri
kii	I	Kitsai
kij	I	Kilivila
kik	I	Kikuyu
kil	I	Kariya
kim	I	Karagas
kin	I	Kinyarwanda
kio	I	Kiowa
kip	I	Sheshi Kham
kiq	I	Kosadle
kir	I	Kirghiz
kis	I	Kis
kit	I	Agob
kiu	I	Kirmanjki (individual language)
kiv	I	Kimbu
kiw	I	Northeast Kiwai
kix	I	Khiamniungan Naga
kiy	I	Kirikiri
kiz	I	Kisi
kja	I	Mlap
kjb	I	Q'anjob'al
kjc	I	Coastal Konjo
kjd	I	Southern Kiwai
kje	I	Kisar
kjg	I	Khmu
kjh	I	Khakas
kji	I	Zabana
kjj	I	Khinalugh
kjk	I	Highland Konjo
kjl	I	Western Parbate Kham
kjm	I	Kháng
kjn	I	Kunjen
kjo	I	Harijan Kinnauri
kjp	I	Pwo Eastern Karen
kjq	I	Western Keres
kjr	I	Kurudu
kjs	I	East Kewa
kjt	I	Phrae Pwo Karen
kju	I	Kashaya
kjv	I	Kaikavian Literary Language
kjx	I	Ramopa
kjy	I	Erave
kjz	I	Bumthangkha
kka	I	Kakanda
kkb	I	Kwerisa
kkc	I	Odoodee
kkd	I	Kinuku
kke	I	Kakabe
kkf	I	Kalaktang Monpa
kkg	I	Mabaka Valley Kalinga
kkh	I	Khün
kki	I	Kagulu
kkj	I	Kako
kkk	I	Kokota
kkl	I	Kosarek Yale
kkm	I	Kiong
kkn	I	Kon Keu
kko	I	Karko
kkp	I	Gugubera
kkq	I	Kaeku
kkr	I	Kir-Balar
kks	I	Giiwo
kkt	I	Koi
kku	I	Tumi
kkv	I	Kangean
kkw	I	Teke-Kukuya
kkx	I	Kohin
kky	I	Guugu Yimidhirr
kkz	I	Kaska
kla	I	Klamath-Modoc
klb	I	Kiliwa
klc	I	Kolbila
kld	I	Gamilaraay
kle	I	Kulung (Nepal)
klf	I	Kendeje
klg	I	Tagakaulo
klh	I	Weliki
kli	I	Kalumpang
klj	I	Khalaj
klk	I	Kono (Nigeria)
kll	I	Kagan Kalagan
klm	I	Migum
kln	M	Kalenjin
klo	I	Kapya
klp	I	Kamasa
klq	I	Rumu
klr	I	Khaling
kls	I	Kalasha
klt	I	Nukna
klu	I	Klao
klv	I	Maskelynes
klw	I	Tado
klx	I	Koluwawa
kly	I	Kalao
klz	I	Kabola
kma	I	Konni
kmb	I	Kimbundu
kmc	I	Southern Dong
kmd	I	Majukayang Kalinga
kme	I	Bakole
kmf	I	Kare (Papua New Guinea)
kmg	I	Kâte
kmh	I	Kalam
kmi	I	Kami (Nigeria)
kmj	I	Kumarbhag Paharia
kmk	I	Limos Kalinga
kml	I	Tanudan Kalinga
kmm	I	Kom (India)
kmn	I	Awtuw
kmo	I	Kwoma
kmp	I	Gimme
kmq	I	Kwama
kmr	I	Northern Kurdish
kms	I	Kamasau
kmt	I	Kemtuik
kmu	I	Kanite
kmv	I	Karipúna Creole French
kmw	I	Komo (Democratic Republic of Congo)
kmx	I	Waboda
kmy	I	Koma
kmz	I	Khorasani Turkish
kna	I	Dera (Nigeria)
knb	I	Lubuagan Kalinga
knc	I	Central Kanuri
knd	I	Konda
kne	I	Kankanaey
knf	I	Mankanya
kng	I	Koongo
kni	I	Kanufi
knj	I	Western Kanjobal
knk	I	Kuranko
knl	I	Keninjal
knm	I	Kanamarí
knn	I	Konkani (individual language)
kno	I	Kono (Sierra Leone)
knp	I	Kwanja
knq	I	Kintaq
knr	I	Kaningra
kns	I	Kensiu
knt	I	Panoan Katukína
knu	I	Kono (Guinea)
knv	I	Tabo
knw	I	Kung-Ekoka
knx	I	Kendayan
kny	I	Kanyok
knz	I	Kalamsé
koa	I	Konomala
koc	I	Kpati
kod	I	Kodi
koe	I	Kacipo-Bale Suri
kof	I	Kubi
kog	I	Cogui
koh	I	Koyo
koi	I	Komi-Permyak
kok	M	Konkani (macrolanguage)
kol	I	Kol (Papua New Guinea)
kom	M	Komi
kon	M	Kongo
koo	I	Konzo
kop	I	Waube
koq	I	Kota (Gabon)
kor	I	Korean
kos	I	Kosraean
kot	I	Lagwan
kou	I	Koke
kov	I	Kudu-Camo
kow	I	Kugama
koy	I	Koyukon
koz	I	Korak
kpa	I	Kutto
kpb	I	Mullu Kurumba
kpc	I	Curripaco
kpd	I	Koba
kpe	M	Kpelle
kpf	I	Komba
kpg	I	Kapingamarangi
kph	I	Kplang
kpi	I	Kofei
kpj	I	Karajá
kpk	I	Kpan
kpl	I	Kpala
kpm	I	Koho
kpn	I	Kepkiriwát
kpo	I	Ikposo
kpq	I	Korupun-Sela
kpr	I	Korafe-Yegha
kps	I	Tehit
kpt	I	Karata
kpu	I	Kafoa
kpv	I	Komi-Zyrian
kpw	I	Kobon
kpx	I	Mountain Koiali
kpy	I	Koryak
kpz	I	Kupsabiny
kqa	I	Mum
kqb	I	Kovai
kqc	I	Doromu-Koki
kqd	I	Koy Sanjaq Surat
kqe	I	Kalagan
kqf	I	Kakabai
kqg	I	Khe
kqh	I	Kisankasa
kqi	I	Koitabu
kqj	I	Koromira
kqk	I	Kotafon Gbe
kql	I	Kyenele
kqm	I	Khisa
kqn	I	Kaonde
kqo	I	Eastern Krahn
kqp	I	Kimré
kqq	I	Krenak
kqr	I	Kimaragang
kqs	I	Northern Kissi
kqt	I	Klias River Kadazan
kqu	I	Seroa
kqv	I	Okolod
kqw	I	Kandas
kqx	I	Mser
kqy	I	Koorete
kqz	I	Korana
kra	I	Kumhali
krb	I	Karkin
krc	I	Karachay-Balkar
krd	I	Kairui-Midiki
kre	I	Panará
krf	I	Koro (Vanuatu)
krh	I	Kurama
kri	I	Krio
krj	I	Kinaray-A
krk	I	Kerek
krl	I	Karelian
krn	I	Sapo
krp	I	Durop
krr	I	Krung
krs	I	Gbaya (Sudan)
krt	I	Tumari Kanuri
kru	I	Kurukh
krv	I	Kavet
krw	I	Western Krahn
krx	I	Karon
kry	I	Kryts
krz	I	Sota Kanum
ksb	I	Shambala
ksc	I	Southern Kalinga
ksd	I	Kuanua
kse	I	Kuni
ksf	I	Bafia
ksg	I	Kusaghe
ksh	I	Kölsch
ksi	I	Krisa
ksj	I	Uare
ksk	I	Kansa
ksl	I	Kumalu
ksm	I	Kumba
ksn	I	Kasiguranin
kso	I	Kofa
ksp	I	Kaba
ksq	I	Kwaami
ksr	I	Borong
kss	I	Southern Kisi
kst	I	Winyé
ksu	I	Khamyang
ksv	I	Kusu
ksw	I	S'gaw Karen
ksx	I	Kedang
ksy	I	Kharia Thar
ksz	I	Kodaku
kta	I	Katua
ktb	I	Kambaata
ktc	I	Kholok
ktd	I	Kokata
kte	I	Nubri
ktf	I	Kwami
ktg	I	Kalkutung
kth	I	Karanga
kti	I	North Muyu
ktj	I	Plapo Krumen
ktk	I	Kaniet
ktl	I	Koroshi
ktm	I	Kurti
ktn	I	Karitiâna
kto	I	Kuot
ktp	I	Kaduo
ktq	I	Katabaga
kts	I	South Muyu
ktt	I	Ketum
ktu	I	Kituba (Democratic Republic of Congo)
ktv	I	Eastern Katu
ktw	I	Kato
ktx	I	Kaxararí
kty	I	Kango (Bas-Uélé District)
ktz	I	Juǀʼhoan
kua	I	Kuanyama
kub	I	Kutep
kuc	I	Kwinsu
kud	I	'Auhelawa
kue	I	Kuman (Papua New Guinea)
kuf	I	Western Katu
kug	I	Kupa
kuh	I	Kushi
kui	I	Kuikúro-Kalapálo
kuj	I	Kuria
kuk	I	Kepo'
kul	I	Kulere
kum	I	Kumyk
kun	I	Kunama
kuo	I	Kumukio
kup	I	Kunimaipa
kuq	I	Karipuna
kur	M	Kurdish
kus	I	Kusaal
kut	I	Kutenai
kuu	I	Upper Kuskokwim
kuv	I	Kur
kuw	I	Kpagua
kux	I	Kukatja
kuy	I	Kuuku-Ya'u
kuz	I	Kunza
kva	I	Bagvalal
kvb	I	Kubu
kvc	I	Kove
kvd	I	Kui (Indonesia)
kve	I	Kalabakan
kvf	I	Kabalai
kvg	I	Kuni-Boazi
kvh	I	Komodo
kvi	I	Kwang
kvj	I	Psikye
kvk	I	Korean Sign Language
kvl	I	Kayaw
kvm	I	Kendem
kvn	I	Border Kuna
kvo	I	Dobel
kvp	I	Kompane
kvq	I	Geba Karen
kvr	I	Kerinci
kvt	I	Lahta Karen
kvu	I	Yinbaw Karen
kvv	I	Kola
kvw	I	Wersing
kvx	I	Parkari Koli
kvy	I	Yintale Karen
kvz	I	Tsakwambo
kwa	I	Dâw
kwb	I	Kwa
kwc	I	Likwala
kwd	I	Kwaio
kwe	I	Kwerba
kwf	I	Kwara'ae
kwg	I	Sara Kaba Deme
kwh	I	Kowiai
kwi	I	Awa-Cuaiquer
kwj	I	Kwanga
kwk	I	Kwak'wala
kwl	I	Kofyar
kwm	I	Kwambi
kwn	I	Kwangali
kwo	I	Kwomtari
kwp	I	Kodia
kwr	I	Kwer
kws	I	Kwese
kwt	I	Kwesten
kwu	I	Kwakum
kwv	I	Sara Kaba Náà
kww	I	Kwinti
kwx	I	Khirwar
kwy	I	San Salvador Kongo
kwz	I	Kwadi
kxa	I	Kairiru
kxb	I	Krobu
kxc	I	Konso
kxd	I	Brunei
kxf	I	Manumanaw Karen
kxh	I	Karo (Ethiopia)
kxi	I	Keningau Murut
kxj	I	Kulfa
kxk	I	Zayein Karen
kxm	I	Northern Khmer
kxn	I	Kanowit-Tanjong Melanau
kxo	I	Kanoé
kxp	I	Wadiyara Koli
kxq	I	Smärky Kanum
kxr	I	Koro (Papua New Guinea)
kxs	I	Kangjia
kxt	I	Koiwat
kxv	I	Kuvi
kxw	I	Konai
kxx	I	Likuba
kxy	I	Kayong
kxz	I	Kerewo
kya	I	Kwaya
kyb	I	Butbut Kalinga
kyc	I	Kyaka
kyd	I	Karey
kye	I	Krache
kyf	I	Kouya
kyg	I	Keyagana
kyh	I	Karok
kyi	I	Kiput
kyj	I	Karao
kyk	I	Kamayo
kyl	I	Kalapuya
kym	I	Kpatili
kyn	I	Northern Binukidnon
kyo	I	Kelon
kyp	I	Kang
kyq	I	Kenga
kyr	I	Kuruáya
kys	I	Baram Kayan
kyt	I	Kayagar
kyu	I	Western Kayah
kyv	I	Kayort
kyw	I	Kudmali
kyx	I	Rapoisi
kyy	I	Kambaira
kyz	I	Kayabí
kza	I	Western Karaboro
kzb	I	Kaibobo
kzc	I	Bondoukou Kulango
kzd	I	Kadai
kze	I	Kosena
kzf	I	Da'a Kaili
kzg	I	Kikai
kzi	I	Kelabit
kzk	I	Kazukuru
kzl	I	Kayeli
kzm	I	Kais
kzn	I	Kokola
kzo	I	Kaningi
kzp	I	Kaidipang
kzq	I	Kaike
kzr	I	Karang
kzs	I	Sugut Dusun
kzu	I	Kayupulau
kzv	I	Komyandaret
kzw	I	Karirí-Xocó
kzx	I	Kamarian
kzy	I	Kango (Tshopo District)
kzz	I	Kalabra
laa	I	Southern Subanen
lab	I	Linear A
lac	I	Lacandon
lad	I	Ladino
lae	I	Pattani
laf	I	Lafofa
lag	I	Rangi
lah	M	Lahnda
lai	I	Lambya
laj	I	Lango (Uganda)
lal	I	Lalia
lam	I	Lamba
lan	I	Laru
lao	I	Lao
lap	I	Laka (Chad)
laq	I	Qabiao
lar	I	Larteh
las	I	Lama (Togo)
lat	I	Latin
lau	I	Laba
lav	M	Latvian
law	I	Lauje
lax	I	Tiwa
lay	I	Lama Bai
laz	I	Aribwatsa
lbb	I	Label
lbc	I	Lakkia
lbe	I	Lak
lbf	I	Tinani
lbg	I	Laopang
lbi	I	La'bi
lbj	I	Ladakhi
lbk	I	Central Bontok
lbl	I	Libon Bikol
lbm	I	Lodhi
lbn	I	Rmeet
lbo	I	Laven
lbq	I	Wampar
lbr	I	Lohorung
lbs	I	Libyan Sign Language
lbt	I	Lachi
lbu	I	Labu
lbv	I	Lavatbura-Lamusong
lbw	I	Tolaki
lbx	I	Lawangan
lby	I	Lamalama
lbz	I	Lardil
lcc	I	Legenyem
lcd	I	Lola
lce	I	Loncong
lcf	I	Lubu
lch	I	Luchazi
lcl	I	Lisela
lcm	I	Tungag
lcp	I	Western Lawa
lcq	I	Luhu
lcs	I	Lisabata-Nuniali
lda	I	Kla-Dan
ldb	I	Dũya
ldd	I	Luri
ldg	I	Lenyima
ldh	I	Lamja-Dengsa-Tola
ldi	I	Laari
ldj	I	Lemoro
ldk	I	Leelau
ldl	I	Kaan
ldm	I	Landoma
ldn	I	Láadan
ldo	I	Loo
ldp	I	Tso
ldq	I	Lufu
lea	I	Lega-Shabunda
leb	I	Lala-Bisa
lec	I	Leco
led	I	Lendu
lee	I	Lyélé
lef	I	Lelemi
leh	I	Lenje
lei	I	Lemio
lej	I	Lengola
lek	I	Leipon
lel	I	Lele (Democratic Republic of Congo)
lem	I	Nomaande
len	I	Lenca
leo	I	Leti (Cameroon)
lep	I	Lepcha
leq	I	Lembena
ler	I	Lenkau
les	I	Lese
let	I	Lesing-Gelimi
leu	I	Kara (Papua New Guinea)
lev	I	Lamma
lew	I	Ledo Kaili
lex	I	Luang
ley	I	Lemolang
lez	I	Lezghian
lfa	I	Lefa
lfn	I	Lingua Franca Nova
lga	I	Lungga
lgb	I	Laghu
lgg	I	Lugbara
lgh	I	Laghuu
lgi	I	Lengilu
lgk	I	Lingarak
lgl	I	Wala
lgm	I	Lega-Mwenga
lgn	I	T'apo
lgo	I	Lango (South Sudan)
lgq	I	Logba
lgr	I	Lengo
lgs	I	Guinea-Bissau Sign Language
lgt	I	Pahi
lgu	I	Longgu
lgz	I	Ligenza
lha	I	Laha (Viet Nam)
lhh	I	Laha (Indonesia)
lhi	I	Lahu Shi
lhl	I	Lahul Lohar
lhm	I	Lhomi
lhn	I	Lahanan
lhp	I	Lhokpu
lhs	I	Mlahsö
lht	I	Lo-Toga
lhu	I	Lahu
lia	I	West-Central Limba
lib	I	Likum
lic	I	Hlai
lid	I	Nyindrou
lie	I	Likila
lif	I	Limbu
lig	I	Ligbi
lih	I	Lihir
lij	I	Ligurian
lik	I	Lika
lil	I	Lillooet
lim	I	Limburgan
lin	I	Lingala
lio	I	Liki
lip	I	Sekpele
liq	I	Libido
lir	I	Liberian English
lis	I	Lisu
lit	I	Lithuanian
liu	I	Logorik
liv	I	Liv
liw	I	Col
lix	I	Liabuku
liy	I	Banda-Bambari
liz	I	Libinza
lja	I	Golpa
lje	I	Rampi
lji	I	Laiyolo
ljl	I	Li'o
ljp	I	Lampung Api
ljw	I	Yirandali
ljx	I	Yuru
lka	I	Lakalei
lkb	I	Kabras
lkc	I	Kucong
lkd	I	Lakondê
lke	I	Kenyi
lkh	I	Lakha
lki	I	Laki
lkj	I	Remun
lkl	I	Laeko-Libuat
lkm	I	Kalaamaya
lkn	I	Lakon
lko	I	Khayo
lkr	I	Päri
lks	I	Kisa
lkt	I	Lakota
lku	I	Kungkari
lky	I	Lokoya
lla	I	Lala-Roba
llb	I	Lolo
llc	I	Lele (Guinea)
lld	I	Ladin
lle	I	Lele (Papua New Guinea)
llf	I	Hermit
llg	I	Lole
llh	I	Lamu
lli	I	Teke-Laali
llj	I	Ladji Ladji
llk	I	Lelak
lll	I	Lilau
llm	I	Lasalimu
lln	I	Lele (Chad)
llp	I	North Efate
llq	I	Lolak
lls	I	Lithuanian Sign Language
llu	I	Lau
llx	I	Lauan
lma	I	East Limba
lmb	I	Merei
lmc	I	Limilngan
lmd	I	Lumun
lme	I	Pévé
lmf	I	South Lembata
lmg	I	Lamogai
lmh	I	Lambichhong
lmi	I	Lombi
lmj	I	West Lembata
lmk	I	Lamkang
lml	I	Hano
lmn	I	Lambadi
lmo	I	Lombard
lmp	I	Limbum
lmq	I	Lamatuka
lmr	I	Lamalera
lmu	I	Lamenu
lmv	I	Lomaiviti
lmw	I	Lake Miwok
lmx	I	Laimbue
lmy	I	Lamboya
lna	I	Langbashe
lnb	I	Mbalanhu
lnd	I	Lundayeh
lng	I	Langobardic
lnh	I	Lanoh
lni	I	Daantanai'
lnj	I	Leningitij
lnl	I	South Central Banda
lnm	I	Langam
lnn	I	Lorediakarkar
lns	I	Lamnso'
lnu	I	Longuda
lnw	I	Lanima
lnz	I	Lonzo
loa	I	Loloda
lob	I	Lobi
loc	I	Inonhan
loe	I	Saluan
lof	I	Logol
log	I	Logo
loh	I	Laarim
loi	I	Loma (Côte d'Ivoire)
loj	I	Lou
lok	I	Loko
lol	I	Mongo
lom	I	Loma (Liberia)
lon	I	Malawi Lomwe
loo	I	Lombo
lop	I	Lopa
loq	I	Lobala
lor	I	Téén
los	I	Loniu
lot	I	Otuho
lou	I	Louisiana Creole
lov	I	Lopi
low	I	Tampias Lobu
lox	I	Loun
loy	I	Loke
loz	I	Lozi
lpa	I	Lelepa
lpe	I	Lepki
lpn	I	Long Phuri Naga
lpo	I	Lipo
lpx	I	Lopit
lqr	I	Logir
lra	I	Rara Bakati'
lrc	I	Northern Luri
lre	I	Laurentian
lrg	I	Laragia
lri	I	Marachi
lrk	I	Loarki
lrl	I	Lari
lrm	I	Marama
lrn	I	Lorang
lro	I	Laro
lrr	I	Southern Yamphu
lrt	I	Larantuka Malay
lrv	I	Larevat
lrz	I	Lemerig
lsa	I	Lasgerdi
lsb	I	Burundian Sign Language
lsc	I	Albarradas Sign Language
lsd	I	Lishana Deni
lse	I	Lusengo
lsh	I	Lish
lsi	I	Lashi
lsl	I	Latvian Sign Language
lsm	I	Saamia
lsn	I	Tibetan Sign Language
lso	I	Laos Sign Language
lsp	I	Panamanian Sign Language
lsr	I	Aruop
lss	I	Lasi
lst	I	Trinidad and Tobago Sign Language
lsv	I	Sivia Sign Language
lsw	I	Seychelles Sign Language
lsy	I	Mauritian Sign Language
ltc	I	Late Middle Chinese
ltg	I	Latgalian
lth	I	Thur
lti	I	Leti (Indonesia)
ltn	I	Latundê
lto	I	Tsotso
lts	I	Tachoni
ltu	I	Latu
ltz	I	Luxembourgish
lua	I	Luba-Lulua
lub	I	Luba-Katanga
luc	I	Aringa
lud	I	Ludian
lue	I	Luvale
luf	I	Laua
lug	I	Ganda
luh	I	Leizhou Chinese
lui	I	Luiseno
luj	I	Luna
luk	I	Lunanakha
lul	I	Olu'bo
lum	I	Luimbi
lun	I	Lunda
luo	I	Luo (Kenya and Tanzania)
lup	I	Lumbu
luq	I	Lucumi
lur	I	Laura
lus	I	Lushai
lut	I	Lushootseed
luu	I	Lumba-Yakkha
luv	I	Luwati
luw	I	Luo (Cameroon)
luy	M	Luyia
luz	I	Southern Luri
lva	I	Maku'a
lvi	I	Lavi
lvk	I	Lavukaleve
lvl	I	Lwel
lvs	I	Standard Latvian
lvu	I	Levuka
lwa	I	Lwalu
lwe	I	Lewo Eleng
lwg	I	Wanga
lwh	I	White Lachi
lwl	I	Eastern Lawa
lwm	I	Laomian
lwo	I	Luwo
lws	I	Malawian Sign Language
lwt	I	Lewotobi
lwu	I	Lawu
lww	I	Lewo
lxm	I	Lakurumau
lya	I	Layakha
lyg	I	Lyngngam
lyn	I	Luyana
lzh	I	Literary Chinese
lzl	I	Litzlitz
lzn	I	Leinong Naga
lzz	I	Laz
maa	I	San Jerónimo Tecóatl Mazatec
mab	I	Yutanduchi Mixtec
mad	I	Madurese
mae	I	Bo-Rukul
maf	I	Mafa
mag	I	Magahi
mah	I	Marshallese
mai	I	Maithili
maj	I	Jalapa De Díaz Mazatec
mak	I	Makasar
mal	I	Malayalam
mam	I	Mam
man	M	Mandingo
maq	I	Chiquihuitlán Mazatec
mar	I	Marathi
mas	I	Masai
mat	I	San Francisco Matlatzinca
mau	I	Huautla Mazatec
mav	I	Sateré-Mawé
maw	I	Mampruli
max	I	North Moluccan Malay
maz	I	Central Mazahua
mba	I	Higaonon
mbb	I	Western Bukidnon Manobo
mbc	I	Macushi
mbd	I	Dibabawon Manobo
mbe	I	Molale
mbf	I	Baba Malay
mbh	I	Mangseng
mbi	I	Ilianen Manobo
mbj	I	Nadëb
mbk	I	Malol
mbl	I	Maxakalí
mbm	I	Ombamba
mbn	I	Macaguán
mbo	I	Mbo (Cameroon)
mbp	I	Malayo
mbq	I	Maisin
mbr	I	Nukak Makú
mbs	I	Sarangani Manobo
mbt	I	Matigsalug Manobo
mbu	I	Mbula-Bwazza
mbv	I	Mbulungish
mbw	I	Maring
mbx	I	Mari (East Sepik Province)
mby	I	Memoni
mbz	I	Amoltepec Mixtec
mca	I	Maca
mcb	I	Machiguenga
mcc	I	Bitur
mcd	I	Sharanahua
mce	I	Itundujia Mixtec
mcf	I	Matsés
mcg	I	Mapoyo
mch	I	Maquiritari
mci	I	Mese
mcj	I	Mvanip
mck	I	Mbunda
mcl	I	Macaguaje
mcm	I	Malaccan Creole Portuguese
mcn	I	Masana
mco	I	Coatlán Mixe
mcp	I	Makaa
mcq	I	Ese
mcr	I	Menya
mcs	I	Mambai
mct	I	Mengisa
mcu	I	Cameroon Mambila
mcv	I	Minanibai
mcw	I	Mawa (Chad)
mcx	I	Mpiemo
mcy	I	South Watut
mcz	I	Mawan
mda	I	Mada (Nigeria)
mdb	I	Morigi
mdc	I	Male (Papua New Guinea)
mdd	I	Mbum
mde	I	Maba (Chad)
mdf	I	Moksha
mdg	I	Massalat
mdh	I	Maguindanaon
mdi	I	Mamvu
mdj	I	Mangbetu
mdk	I	Mangbutu
mdl	I	Maltese Sign Language
mdm	I	Mayogo
mdn	I	Mbati
mdp	I	Mbala
mdq	I	Mbole
mdr	I	Mandar
mds	I	Maria (Papua New Guinea)
mdt	I	Mbere
mdu	I	Mboko
mdv	I	Santa Lucía Monteverde Mixtec
mdw	I	Mbosi
mdx	I	Dizin
mdy	I	Male (Ethiopia)
mdz	I	Suruí Do Pará
mea	I	Menka
meb	I	Ikobi
mec	I	Marra
med	I	Melpa
mee	I	Mengen
mef	I	Megam
meh	I	Southwestern Tlaxiaco Mixtec
mei	I	Midob
mej	I	Meyah
mek	I	Mekeo
mel	I	Central Melanau
mem	I	Mangala
men	I	Mende (Sierra Leone)
meo	I	Kedah Malay
mep	I	Miriwoong
meq	I	Merey
mer	I	Meru
mes	I	Masmaje
met	I	Mato
meu	I	Motu
mev	I	Mano
mew	I	Maaka
mey	I	Hassaniyya
mez	I	Menominee
mfa	I	Pattani Malay
mfb	I	Bangka
mfc	I	Mba
mfd	I	Mendankwe-Nkwen
mfe	I	Morisyen
mff	I	Naki
mfg	I	Mogofin
mfh	I	Matal
mfi	I	Wandala
mfj	I	Mefele
mfk	I	North Mofu
mfl	I	Putai
mfm	I	Marghi South
mfn	I	Cross River Mbembe
mfo	I	Mbe
mfp	I	Makassar Malay
mfq	I	Moba
mfr	I	Marrithiyel
mfs	I	Mexican Sign Language
mft	I	Mokerang
mfu	I	Mbwela
mfv	I	Mandjak
mfw	I	Mulaha
mfx	I	Melo
mfy	I	Mayo
mfz	I	Mabaan
mga	I	Middle Irish (900-1200)
mgb	I	Mararit
mgc	I	Morokodo
mgd	I	Moru
mge	I	Mango
mgf	I	Maklew
mgg	I	Mpumpong
mgh	I	Makhuwa-Meetto
mgi	I	Lijili
mgj	I	Abureni
mgk	I	Mawes
mgl	I	Maleu-Kilenge
mgm	I	Mambae
mgn	I	Mbangi
mgo	I	Meta'
mgp	I	Eastern Magar
mgq	I	Malila
mgr	I	Mambwe-Lungu
mgs	I	Manda (Tanzania)
mgt	I	Mongol
mgu	I	Mailu
mgv	I	Matengo
mgw	I	Matumbi
mgy	I	Mbunga
mgz	I	Mbugwe
mha	I	Manda (India)
mhb	I	Mahongwe
mhc	I	Mocho
mhd	I	Mbugu
mhe	I	Besisi
mhf	I	Mamaa
mhg	I	Margu
mhi	I	Ma'di
mhj	I	Mogholi
mhk	I	Mungaka
mhl	I	Mauwake
mhm	I	Makhuwa-Moniga
mhn	I	Mòcheno
mho	I	Mashi (Zambia)
mhp	I	Balinese Malay
mhq	I	Mandan
mhr	I	Eastern Mari
mhs	I	Buru (Indonesia)
mht	I	Mandahuaca
mhu	I	Digaro-Mishmi
mhw	I	Mbukushu
mhx	I	Maru
mhy	I	Ma'anyan
mhz	I	Mor (Mor Islands)
mia	I	Miami
mib	I	Atatláhuca Mixtec
mic	I	Mi'kmaq
mid	I	Mandaic
mie	I	Ocotepec Mixtec
mif	I	Mofu-Gudur
mig	I	San Miguel El Grande Mixtec
mih	I	Chayuco Mixtec
mii	I	Chigmecatitlán Mixtec
mij	I	Abar
mik	I	Mikasuki
mil	I	Peñoles Mixtec
mim	I	Alacatlatzala Mixtec
min	I	Minangkabau
mio	I	Pinotepa Nacional Mixtec
mip	I	Apasco-Apoala Mixtec
miq	I	Mískito
mir	I	Isthmus Mixe
mis	S	Uncoded languages
mit	I	Southern Puebla Mixtec
miu	I	Cacaloxtepec Mixtec
miw	I	Akoye
mix	I	Mixtepec Mixtec
miy	I	Ayutla Mixtec
miz	I	Coatzospan Mixtec
mjb	I	Makalero
mjc	I	San Juan Colorado Mixtec
mjd	I	Northwest Maidu
mje	I	Muskum
mjg	I	Tu
mjh	I	Mwera (Nyasa)
mji	I	Kim Mun
mjj	I	Mawak
mjk	I	Matukar
mjl	I	Mandeali
mjm	I	Medebur
mjn	I	Ma (Papua New Guinea)
mjo	I	Malankuravan
mjp	I	Malapandaram
mjq	I	Malaryan
mjr	I	Malavedan
mjs	I	Miship
mjt	I	Sauria Paharia
mju	I	Manna-Dora
mjv	I	Mannan
mjw	I	Karbi
mjx	I	Mahali
mjy	I	Mahican
mjz	I	Majhi
mka	I	Mbre
mkb	I	Mal Paharia
mkc	I	Siliput
mkd	I	Macedonian
mke	I	Mawchi
mkf	I	Miya
mkg	I	Mak (China)
mki	I	Dhatki
mkj	I	Mokilese
mkk	I	Byep
mkl	I	Mokole
mkm	I	Moklen
mkn	I	Kupang Malay
mko	I	Mingang Doso
mkp	I	Moikodi
mkq	I	Bay Miwok
mkr	I	Malas
mks	I	Silacayoapan Mixtec
mkt	I	Vamale
mku	I	Konyanka Maninka
mkv	I	Mafea
mkw	I	Kituba (Congo)
mkx	I	Kinamiging Manobo
mky	I	East Makian
mkz	I	Makasae
mla	I	Malo
mlb	I	Mbule
mlc	I	Cao Lan
mle	I	Manambu
mlf	I	Mal
mlg	M	Malagasy
mlh	I	Mape
mli	I	Malimpung
mlj	I	Miltu
mlk	I	Ilwana
mll	I	Malua Bay
mlm	I	Mulam
mln	I	Malango
mlo	I	Mlomp
mlp	I	Bargam
mlq	I	Western Maninkakan
mlr	I	Vame
mls	I	Masalit
mlt	I	Maltese
mlu	I	To'abaita
mlv	I	Motlav
mlw	I	Moloko
mlx	I	Malfaxal
mlz	I	Malaynon
mma	I	Mama
mmb	I	Momina
mmc	I	Michoacán Mazahua
mmd	I	Maonan
mme	I	Mae
mmf	I	Mundat
mmg	I	North Ambrym
mmh	I	Mehináku
mmi	I	Hember Avu
mmj	I	Majhwar
mmk	I	Mukha-Dora
mml	I	Man Met
mmm	I	Maii
mmn	I	Mamanwa
mmo	I	Mangga Buang
mmp	I	Siawi
mmq	I	Musak
mmr	I	Western Xiangxi Miao
mmt	I	Malalamai
mmu	I	Mmaala
mmv	I	Miriti
mmw	I	Emae
mmx	I	Madak
mmy	I	Migaama
mmz	I	Mabaale
mna	I	Mbula
mnb	I	Muna
mnc	I	Manchu
mnd	I	Mondé
mne	I	Naba
mnf	I	Mundani
mng	I	Eastern Mnong
mnh	I	Mono (Democratic Republic of Congo)
mni	I	Manipuri
mnj	I	Munji
mnk	I	Mandinka
mnl	I	Tiale
mnm	I	Mapena
mnn	I	Southern Mnong
mnp	I	Min Bei Chinese
mnq	I	Minriq
mnr	I	Mono (USA)
mns	I	Mansi
mnu	I	Mer
mnv	I	Rennell-Bellona
mnw	I	Mon
mnx	I	Manikion
mny	I	Manyawa
mnz	I	Moni
moa	I	Mwan
moc	I	Mocoví
mod	I	Mobilian
moe	I	Innu
mog	I	Mongondow
moh	I	Mohawk
moi	I	Mboi
moj	I	Monzombo
mok	I	Morori
mom	I	Mangue
mon	M	Mongolian
moo	I	Monom
mop	I	Mopán Maya
moq	I	Mor (Bomberai Peninsula)
mor	I	Moro
mos	I	Mossi
mot	I	Barí
mou	I	Mogum
mov	I	Mohave
mow	I	Moi (Congo)
mox	I	Molima
moy	I	Shekkacho
moz	I	Mukulu
mpa	I	Mpoto
mpb	I	Malak Malak
mpc	I	Mangarrayi
mpd	I	Machinere
mpe	I	Majang
mpg	I	Marba
mph	I	Maung
mpi	I	Mpade
mpj	I	Martu Wangka
mpk	I	Mbara (Chad)
mpl	I	Middle Watut
mpm	I	Yosondúa Mixtec
mpn	I	Mindiri
mpo	I	Miu
mpp	I	Migabac
mpq	I	Matís
mpr	I	Vangunu
mps	I	Dadibi
mpt	I	Mian
mpu	I	Makuráp
mpv	I	Mungkip
mpw	I	Mapidian
mpx	I	Misima-Panaeati
mpy	I	Mapia
mpz	I	Mpi
mqa	I	Maba (Indonesia)
mqb	I	Mbuko
mqc	I	Mangole
mqe	I	Matepi
mqf	I	Momuna
mqg	I	Kota Bangun Kutai Malay
mqh	I	Tlazoyaltepec Mixtec
mqi	I	Mariri
mqj	I	Mamasa
mqk	I	Rajah Kabunsuwan Manobo
mql	I	Mbelime
mqm	I	South Marquesan
mqn	I	Moronene
mqo	I	Modole
mqp	I	Manipa
mqq	I	Minokok
mqr	I	Mander
mqs	I	West Makian
mqt	I	Mok
mqu	I	Mandari
mqv	I	Mosimo
mqw	I	Murupi
mqx	I	Mamuju
mqy	I	Manggarai
mqz	I	Pano
mra	I	Mlabri
mrb	I	Marino
mrc	I	Maricopa
mrd	I	Western Magar
mre	I	Martha's Vineyard Sign Language
mrf	I	Elseng
mrg	I	Mising
mrh	I	Mara Chin
mri	I	Maori
mrj	I	Western Mari
mrk	I	Hmwaveke
mrl	I	Mortlockese
mrm	I	Merlav
mrn	I	Cheke Holo
mro	I	Mru
mrp	I	Morouas
mrq	I	North Marquesan
mrr	I	Maria (India)
mrs	I	Maragus
mrt	I	Marghi Central
mru	I	Mono (Cameroon)
mrv	I	Mangareva
mrw	I	Maranao
mrx	I	Maremgi
mry	I	Mandaya
mrz	I	Marind
msa	M	Malay (macrolanguage)
msb	I	Masbatenyo
msc	I	Sankaran Maninka
msd	I	Yucatec Maya Sign Language
mse	I	Musey
msf	I	Mekwei
msg	I	Moraid
msh	I	Masikoro Malagasy
msi	I	Sabah Malay
msj	I	Ma (Democratic Republic of Congo)
msk	I	Mansaka
msl	I	Molof
msm	I	Agusan Manobo
msn	I	Vurës
mso	I	Mombum
msp	I	Maritsauá
msq	I	Caac
msr	I	Mongolian Sign Language
mss	I	West Masela
msu	I	Musom
msv	I	Maslam
msw	I	Mansoanka
msx	I	Moresada
msy	I	Aruamu
msz	I	Momare
mta	I	Cotabato Manobo
mtb	I	Anyin Morofo
mtc	I	Munit
mtd	I	Mualang
mte	I	Mono (Solomon Islands)
mtf	I	Murik (Papua New Guinea)
mtg	I	Una
mth	I	Munggui
mti	I	Maiwa (Papua New Guinea)
mtj	I	Moskona
mtk	I	Mbe'
mtl	I	Montol
mtm	I	Mator
mtn	I	Matagalpa
mto	I	Totontepec Mixe
mtp	I	Wichí Lhamtés Nocten
mtq	I	Muong
mtr	I	Mewari
mts	I	Yora
mtt	I	Mota
mtu	I	Tututepec Mixtec
mtv	I	Asaro'o
mtw	I	Southern Binukidnon
mtx	I	Tidaá Mixtec
mty	I	Nabi
mua	I	Mundang
mub	I	Mubi
muc	I	Ajumbu
mud	I	Mednyj Aleut
mue	I	Media Lengua
mug	I	Musgu
muh	I	Mündü
mui	I	Musi
muj	I	Mabire
muk	I	Mugom
mul	S	Multiple languages
mum	I	Maiwala
muo	I	Nyong
mup	I	Malvi
muq	I	Eastern Xiangxi Miao
mur	I	Murle
mus	I	Creek
mut	I	Western Muria
muu	I	Yaaku
muv	I	Muthuvan
mux	I	Bo-Ung
muy	I	Muyang
muz	I	Mursi
mva	I	Manam
mvb	I	Mattole
mvd	I	Mamboru
mve	I	Marwari (Pakistan)
mvf	I	Peripheral Mongolian
mvg	I	Yucuañe Mixtec
mvh	I	Mulgi
mvi	I	Miyako
mvk	I	Mekmek
mvl	I	Mbara (Australia)
mvn	I	Minaveha
mvo	I	Marovo
mvp	I	Duri
mvq	I	Moere
mvr	I	Marau
mvs	I	Massep
mvt	I	Mpotovoro
mvu	I	Marfa
mvv	I	Tagal Murut
mvw	I	Machinga
mvx	I	Meoswar
mvy	I	Indus Kohistani
mvz	I	Mesqan
mwa	I	Mwatebu
mwb	I	Juwal
mwc	I	Are
mwe	I	Mwera (Chimwera)
mwf	I	Murrinh-Patha
mwg	I	Aiklep
mwh	I	Mouk-Aria
mwi	I	Labo
mwk	I	Kita Maninkakan
mwl	I	Mirandese
mwm	I	Sar
mwn	I	Nyamwanga
mwo	I	Central Maewo
mwp	I	Kala Lagaw Ya
mwq	I	Mün Chin
mwr	M	Marwari
mws	I	Mwimbi-Muthambi
mwt	I	Moken
mwu	I	Mittu
mwv	I	Mentawai
mww	I	Hmong Daw
mwz	I	Moingi
mxa	I	Northwest Oaxaca Mixtec
mxb	I	Tezoatlán Mixtec
mxc	I	Manyika
mxd	I	Modang
mxe	I	Mele-Fila
mxf	I	Malgbe
mxg	I	Mbangala
mxh	I	Mvuba
mxi	I	Mozarabic
mxj	I	Miju-Mishmi
mxk	I	Monumbo
mxl	I	Maxi Gbe
mxm	I	Meramera
mxn	I	Moi (Indonesia)
mxo	I	Mbowe
mxp	I	Tlahuitoltepec Mixe
mxq	I	Juquila Mixe
mxr	I	Murik (Malaysia)
mxs	I	Huitepec Mixtec
mxt	I	Jamiltepec Mixtec
mxu	I	Mada (Cameroon)
mxv	I	Metlatónoc Mixtec
mxw	I	Namo
mxx	I	Mahou
mxy	I	Southeastern Nochixtlán Mixtec
mxz	I	Central Masela
mya	I	Burmese
myb	I	Mbay
myc	I	Mayeka
mye	I	Myene
myf	I	Bambassi
myg	I	Manta
myh	I	Makah
myj	I	Mangayat
myk	I	Mamara Senoufo
myl	I	Moma
mym	I	Me'en
myo	I	Anfillo
myp	I	Pirahã
myr	I	Muniche
mys	I	Mesmes
myu	I	Mundurukú
myv	I	Erzya
myw	I	Muyuw
myx	I	Masaaba
myy	I	Macuna
myz	I	Classical Mandaic
mza	I	Santa María Zacatepec Mixtec
mzb	I	Tumzabt
mzc	I	Madagascar Sign Language
mzd	I	Malimba
mze	I	Morawa
mzg	I	Monastic Sign Language
mzh	I	Wichí Lhamtés Güisnay
mzi	I	Ixcatlán Mazatec
mzj	I	Manya
mzk	I	Nigeria Mambila
mzl	I	Mazatlán Mixe
mzm	I	Mumuye
mzn	I	Mazanderani
mzo	I	Matipuhy
mzp	I	Movima
mzq	I	Mori Atas
mzr	I	Marúbo
mzs	I	Macanese
mzt	I	Mintil
mzu	I	Inapang
mzv	I	Manza
mzw	I	Deg
mzx	I	Mawayana
mzy	I	Mozambican Sign Language
mzz	I	Maiadomu
naa	I	Namla
nab	I	Southern Nambikuára
nac	I	Narak
nae	I	Naka'ela
naf	I	Nabak
nag	I	Naga Pidgin
naj	I	Nalu
nak	I	Nakanai
nal	I	Nalik
nam	I	Ngan'gityemerri
nan	I	Min Nan Chinese
nao	I	Naaba
nap	I	Neapolitan
naq	I	Khoekhoe
nar	I	Iguta
nas	I	Naasioi
nat	I	Ca̱hungwa̱rya̱
nau	I	Nauru
nav	I	Navajo
naw	I	Nawuri
nax	I	Nakwi
nay	I	Ngarrindjeri
naz	I	Coatepec Nahuatl
nba	I	Nyemba
nbb	I	Ndoe
nbc	I	Chang Naga
nbd	I	Ngbinda
nbe	I	Konyak Naga
nbg	I	Nagarchal
nbh	I	Ngamo
nbi	I	Mao Naga
nbj	I	Ngarinyman
nbk	I	Nake
nbl	I	South Ndebele
nbm	I	Ngbaka Ma'bo
nbn	I	Kuri
nbo	I	Nkukoli
nbp	I	Nnam
nbq	I	Nggem
nbr	I	Numana
nbs	I	Namibian Sign Language
nbt	I	Na
nbu	I	Rongmei Naga
nbv	I	Ngamambo
nbw	I	Southern Ngbandi
nby	I	Ningera
nca	I	Iyo
ncb	I	Central Nicobarese
ncc	I	Ponam
ncd	I	Nachering
nce	I	Yale
ncf	I	Notsi
ncg	I	Nisga'a
nch	I	Central Huasteca Nahuatl
nci	I	Classical Nahuatl
ncj	I	Northern Puebla Nahuatl
nck	I	Na-kara
ncl	I	Michoacán Nahuatl
ncm	I	Nambo
ncn	I	Nauna
nco	I	Sibe
ncq	I	Northern Katang
ncr	I	Ncane
ncs	I	Nicaraguan Sign Language
nct	I	Chothe Naga
ncu	I	Chumburung
ncx	I	Central Puebla Nahuatl
ncz	I	Natchez
nda	I	Ndasa
ndb	I	Kenswei Nsei
ndc	I	Ndau
ndd	I	Nde-Nsele-Nta
nde	I	North Ndebele
ndf	I	Nadruvian
ndg	I	Ndengereko
ndh	I	Ndali
ndi	I	Samba Leko
ndj	I	Ndamba
ndk	I	Ndaka
ndl	I	Ndolo
ndm	I	Ndam
ndn	I	Ngundi
ndo	I	Ndonga
ndp	I	Ndo
ndq	I	Ndombe
ndr	I	Ndoola
nds	I	Low German
ndt	I	Ndunga
ndu	I	Dugun
ndv	I	Ndut
ndw	I	Ndobo
ndx	I	Nduga
ndy	I	Lutos
ndz	I	Ndogo
nea	I	Eastern Ngad'a
neb	I	Toura (Côte d'Ivoire)
nec	I	Nedebang
ned	I	Nde-Gbite
nee	I	Nêlêmwa-Nixumwak
nef	I	Nefamese
neg	I	Negidal
neh	I	Nyenkha
nei	I	Neo-Hittite
nej	I	Neko
nek	I	Neku
nem	I	Nemi
nen	I	Nengone
neo	I	Ná-Meo
nep	M	Nepali (macrolanguage)
neq	I	North Central Mixe
ner	I	Yahadian
nes	I	Bhoti Kinnauri
net	I	Nete
neu	I	Neo
nev	I	Nyaheun
new	I	Nepal Bhasa
nex	I	Neme
ney	I	Neyo
nez	I	Nez Perce
nfa	I	Dhao
nfd	I	Ahwai
nfl	I	Ayiwo
nfr	I	Nafaanra
nfu	I	Mfumte
nga	I	Ngbaka
ngb	I	Northern Ngbandi
ngc	I	Ngombe (Democratic Republic of Congo)
ngd	I	Ngando (Central African Republic)
nge	I	Ngemba
ngg	I	Ngbaka Manza
ngh	I	Nǁng
ngi	I	Ngizim
ngj	I	Ngie
ngk	I	Dalabon
ngl	I	Lomwe
ngm	I	Ngatik Men's Creole
ngn	I	Ngwo
ngp	I	Ngulu
ngq	I	Ngurimi
ngr	I	Engdewu
ngs	I	Gvoko
ngt	I	Kriang
ngu	I	Guerrero Nahuatl
ngv	I	Nagumi
ngw	I	Ngwaba
ngx	I	Nggwahyi
ngy	I	Tibea
ngz	I	Ngungwel
nha	I	Nhanda
nhb	I	Beng
nhc	I	Tabasco Nahuatl
nhd	I	Chiripá
nhe	I	Eastern Huasteca Nahuatl
nhf	I	Nhuwala
nhg	I	Tetelcingo Nahuatl
nhh	I	Nahari
nhi	I	Zacatlán-Ahuacatlán-Tepetzintla Nahuatl
nhk	I	Isthmus-Cosoleacaque Nahuatl
nhm	I	Morelos Nahuatl
nhn	I	Central Nahuatl
nho	I	Takuu
nhp	I	Isthmus-Pajapan Nahuatl
nhq	I	Huaxcaleca Nahuatl
nhr	I	Naro
nht	I	Ometepec Nahuatl
nhu	I	Noone
nhv	I	Temascaltepec Nahuatl
nhw	I	Western Huasteca Nahuatl
nhx	I	Isthmus-Mecayapan Nahuatl
nhy	I	Northern Oaxaca Nahuatl
nhz	I	Santa María La Alta Nahuatl
nia	I	Nias
nib	I	Nakame
nid	I	Ngandi
nie	I	Niellim
nif	I	Nek
nig	I	Ngalakgan
nih	I	Nyiha (Tanzania)
nii	I	Nii
nij	I	Ngaju
nik	I	Southern Nicobarese
nil	I	Nila
nim	I	Nilamba
nin	I	Ninzo
nio	I	Nganasan
niq	I	Nandi
nir	I	Nimboran
nis	I	Nimi
nit	I	Southeastern Kolami
niu	I	Niuean
niv	I	Gilyak
niw	I	Nimo
nix	I	Hema
niy	I	Ngiti
niz	I	Ningil
nja	I	Nzanyi
njb	I	Nocte Naga
njd	I	Ndonde Hamba
njh	I	Lotha Naga
nji	I	Gudanji
njj	I	Njen
njl	I	Njalgulgule
njm	I	Angami Naga
njn	I	Liangmai Naga
njo	I	Ao Naga
njr	I	Njerep
njs	I	Nisa
njt	I	Ndyuka-Trio Pidgin
nju	I	Ngadjunmaya
njx	I	Kunyi
njy	I	Njyem
njz	I	Nyishi
nka	I	Nkoya
nkb	I	Khoibu Naga
nkc	I	Nkongho
nkd	I	Koireng
nke	I	Duke
nkf	I	Inpui Naga
nkg	I	Nekgini
nkh	I	Khezha Naga
nki	I	Thangal Naga
nkj	I	Nakai
nkk	I	Nokuku
nkm	I	Namat
nkn	I	Nkangala
nko	I	Nkonya
nkp	I	Niuatoputapu
nkq	I	Nkami
nkr	I	Nukuoro
nks	I	North Asmat
nkt	I	Nyika (Tanzania)
nku	I	Bouna Kulango
nkv	I	Nyika (Malawi and Zambia)
nkw	I	Nkutu
nkx	I	Nkoroo
nkz	I	Nkari
nla	I	Ngombale
nlc	I	Nalca
nld	I	Dutch
nle	I	East Nyala
nlg	I	Gela
nli	I	Grangali
nlj	I	Nyali
nlk	I	Ninia Yali
nll	I	Nihali
nlm	I	Mankiyali
nlo	I	Ngul
nlq	I	Lao Naga
nlu	I	Nchumbulu
nlv	I	Orizaba Nahuatl
nlw	I	Walangama
nlx	I	Nahali
nly	I	Nyamal
nlz	I	Nalögo
nma	I	Maram Naga
nmb	I	Big Nambas
nmc	I	Ngam
nmd	I	Ndumu
nme	I	Mzieme Naga
nmf	I	Tangkhul Naga (India)
nmg	I	Kwasio
nmh	I	Monsang Naga
nmi	I	Nyam
nmj	I	Ngombe (Central African Republic)
nmk	I	Namakura
nml	I	Ndemli
nmm	I	Manangba
nmn	I	ǃXóõ
nmo	I	Moyon Naga
nmp	I	Nimanbur
nmq	I	Nambya
nmr	I	Nimbari
nms	I	Letemboi
nmt	I	Namonuito
nmu	I	Northeast Maidu
nmv	I	Ngamini
nmw	I	Nimoa
nmx	I	Nama (Papua New Guinea)
nmy	I	Namuyi
nmz	I	Nawdm
nna	I	Nyangumarta
nnb	I	Nande
nnc	I	Nancere
nnd	I	West Ambae
nne	I	Ngandyera
nnf	I	Ngaing
nng	I	Maring Naga
nnh	I	Ngiemboon
nni	I	North Nuaulu
nnj	I	Nyangatom
nnk	I	Nankina
nnl	I	Northern Rengma Naga
nnm	I	Namia
nnn	I	Ngete
nno	I	Norwegian Nynorsk
nnp	I	Wancho Naga
nnq	I	Ngindo
nnr	I	Narungga
nnt	I	Nanticoke
nnu	I	Dwang
nnv	I	Nugunu (Australia)
nnw	I	Southern Nuni
nny	I	Nyangga
nnz	I	Nda'nda'
noa	I	Woun Meu
nob	I	Norwegian Bokmål
noc	I	Nuk
nod	I	Northern Thai
noe	I	Nimadi
nof	I	Nomane
nog	I	Nogai
noh	I	Nomu
noi	I	Noiri
noj	I	Nonuya
nok	I	Nooksack
nol	I	Nomlaki
non	I	Old Norse
nop	I	Numanggang
noq	I	Ngongo
nor	M	Norwegian
nos	I	Eastern Nisu
not	I	Nomatsiguenga
nou	I	Ewage-Notu
nov	I	Novial
now	I	Nyambo
noy	I	Noy
noz	I	Nayi
npa	I	Nar Phu
npb	I	Nupbikha
npg	I	Ponyo-Gongwang Naga
nph	I	Phom Naga
npi	I	Nepali (individual language)
npl	I	Southeastern Puebla Nahuatl
npn	I	Mondropolon
npo	I	Pochuri Naga
nps	I	Nipsan
npu	I	Puimei Naga
npx	I	Noipx
npy	I	Napu
nqg	I	Southern Nago
nqk	I	Kura Ede Nago
nql	I	Ngendelengo
nqm	I	Ndom
nqn	I	Nen
nqo	I	N'Ko
nqq	I	Kyan-Karyaw Naga
nqt	I	Nteng
nqy	I	Akyaung Ari Naga
nra	I	Ngom
nrb	I	Nara
nrc	I	Noric
nre	I	Southern Rengma Naga
nrf	I	Jèrriais
nrg	I	Narango
nri	I	Chokri Naga
nrk	I	Ngarla
nrl	I	Ngarluma
nrm	I	Narom
nrn	I	Norn
nrp	I	North Picene
nrr	I	Norra
nrt	I	Northern Kalapuya
nru	I	Narua
nrx	I	Ngurmbur
nrz	I	Lala
nsa	I	Sangtam Naga
nsb	I	Lower Nossob
nsc	I	Nshi
nsd	I	Southern Nisu
nse	I	Nsenga
nsf	I	Northwestern Nisu
nsg	I	Ngasa
nsh	I	Ngoshie
nsi	I	Nigerian Sign Language
nsk	I	Naskapi
nsl	I	Norwegian Sign Language
nsm	I	Sumi Naga
nsn	I	Nehan
nso	I	Pedi
nsp	I	Nepalese Sign Language
nsq	I	Northern Sierra Miwok
nsr	I	Maritime Sign Language
nss	I	Nali
nst	I	Tase Naga
nsu	I	Sierra Negra Nahuatl
nsv	I	Southwestern Nisu
nsw	I	Navut
nsx	I	Nsongo
nsy	I	Nasal
nsz	I	Nisenan
ntd	I	Northern Tidung
ntg	I	Ngantangarra
nti	I	Natioro
ntj	I	Ngaanyatjarra
ntk	I	Ikoma-Nata-Isenye
ntm	I	Nateni
nto	I	Ntomba
ntp	I	Northern Tepehuan
ntr	I	Delo
ntu	I	Natügu
ntw	I	Nottoway
ntx	I	Tangkhul Naga (Myanmar)
nty	I	Mantsi
ntz	I	Natanzi
nua	I	Yuanga
nuc	I	Nukuini
nud	I	Ngala
nue	I	Ngundu
nuf	I	Nusu
nug	I	Nungali
nuh	I	Ndunda
nui	I	Ngumbi
nuj	I	Nyole
nuk	I	Nuu-chah-nulth
nul	I	Nusa Laut
num	I	Niuafo'ou
nun	I	Anong
nuo	I	Nguôn
nup	I	Nupe-Nupe-Tako
nuq	I	Nukumanu
nur	I	Nukuria
nus	I	Nuer
nut	I	Nung (Viet Nam)
nuu	I	Ngbundu
nuv	I	Northern Nuni
nuw	I	Nguluwan
nux	I	Mehek
nuy	I	Nunggubuyu
nuz	I	Tlamacazapa Nahuatl
nvh	I	Nasarian
nvm	I	Namiae
nvo	I	Nyokon
nwa	I	Nawathinehena
nwb	I	Nyabwa
nwc	I	Classical Newari
nwe	I	Ngwe
nwg	I	Ngayawung
nwi	I	Southwest Tanna
nwm	I	Nyamusa-Molo
nwo	I	Nauo
nwr	I	Nawaru
nww	I	Ndwewe
nwx	I	Middle Newar
nwy	I	Nottoway-Meherrin
nxa	I	Nauete
nxd	I	Ngando (Democratic Republic of Congo)
nxe	I	Nage
nxg	I	Ngad'a
nxi	I	Nindi
nxk	I	Koki Naga
nxl	I	South Nuaulu
nxm	I	Numidian
nxn	I	Ngawun
nxo	I	Ndambomo
nxq	I	Naxi
nxr	I	Ninggerum
nxx	I	Nafri
nya	I	Chichewa
nyb	I	Nyangbo
nyc	I	Nyanga-li
nyd	I	Nyore
nye	I	Nyengo
nyf	I	Giryama
nyg	I	Nyindu
nyh	I	Nyikina
nyi	I	Ama (Sudan)
nyj	I	Nyanga
nyk	I	Nyaneka
nyl	I	Nyeu
nym	I	Nyamwezi
nyn	I	Nyankole
nyo	I	Nyoro
nyp	I	Nyang'i
nyq	I	Nayini
nyr	I	Nyiha (Malawi)
nys	I	Nyungar
nyt	I	Nyawaygi
nyu	I	Nyungwe
nyv	I	Nyulnyul
nyw	I	Nyaw
nyx	I	Nganyaywana
nyy	I	Nyakyusa-Ngonde
nza	I	Tigon Mbembe
nzb	I	Njebi
nzd	I	Nzadi
nzi	I	Nzima
nzk	I	Nzakara
nzm	I	Zeme Naga
nzr	I	Dir-Nyamzak-Mbarimi
nzs	I	New Zealand Sign Language
nzu	I	Teke-Nzikou
nzy	I	Nzakambay
nzz	I	Nanga Dama Dogon
oaa	I	Orok
oac	I	Oroch
oak	I	Noakhali
oar	I	Old Aramaic (up to 700 BCE)
oav	I	Old Avar
obi	I	Obispeño
obk	I	Southern Bontok
obl	I	Oblo
obm	I	Moabite
obo	I	Obo Manobo
obr	I	Old Burmese
obt	I	Old Breton
obu	I	Obulom
oca	I	Ocaina
och	I	Old Chinese
oci	I	Occitan (post 1500)
ocm	I	Old Cham
oco	I	Old Cornish
ocu	I	Atzingo Matlatzinca
oda	I	Odut
odk	I	Od
odt	I	Old Dutch
odu	I	Odual
ofo	I	Ofo
ofs	I	Old Frisian
ofu	I	Efutop
ogb	I	Ogbia
ogc	I	Ogbah
oge	I	Old Georgian
ogg	I	Ogbogolo
ogo	I	Khana
ogu	I	Ogbronuagum
oht	I	Old Hittite
ohu	I	Old Hungarian
oia	I	Oirata
oie	I	Okolie
oin	I	Inebu One
ojb	I	Northwestern Ojibwa
ojc	I	Central Ojibwa
ojg	I	Eastern Ojibwa
oji	M	Ojibwa
ojp	I	Old Japanese
ojs	I	Severn Ojibwa
ojv	I	Ontong Java
ojw	I	Western Ojibwa
oka	I	Okanagan
okb	I	Okobo
okc	I	Kobo
okd	I	Okodia
oke	I	Okpe (Southwestern Edo)
okg	I	Koko Babangk
okh	I	Koresh-e Rostam
oki	I	Okiek
okj	I	Oko-Juwoi
okk	I	Kwamtim One
okl	I	Old Kentish Sign Language
okm	I	Middle Korean (10th-16th cent.)
okn	I	Oki-No-Erabu
oko	I	Old Korean (3rd-9th cent.)
okr	I	Kirike
oks	I	Oko-Eni-Osayen
oku	I	Oku
okv	I	Orokaiva
okx	I	Okpe (Northwestern Edo)
okz	I	Old Khmer
ola	I	Walungge
old	I	Mochi
ole	I	Olekha
olk	I	Olkol
olm	I	Oloma
olo	I	Livvi
olr	I	Olrat
olt	I	Old Lithuanian
olu	I	Kuvale
oma	I	Omaha-Ponca
omb	I	East Ambae
omc	I	Mochica
omg	I	Omagua
omi	I	Omi
omk	I	Omok
oml	I	Ombo
omn	I	Minoan
omo	I	Utarmbung
omp	I	Old Manipuri
omr	I	Old Marathi
omt	I	Omotik
omu	I	Omurano
omw	I	South Tairora
omx	I	Old Mon
omy	I	Old Malay
ona	I	Ona
onb	I	Lingao
one	I	Oneida
ong	I	Olo
oni	I	Onin
onj	I	Onjob
onk	I	Kabore One
onn	I	Onobasulu
ono	I	Onondaga
onp	I	Sartang
onr	I	Northern One
ons	I	Ono
ont	I	Ontenu
onu	I	Unua
onw	I	Old Nubian
onx	I	Onin Based Pidgin
ood	I	Tohono O'odham
oog	I	Ong
oon	I	Önge
oor	I	Oorlams
oos	I	Old Ossetic
opa	I	Okpamheri
opk	I	Kopkaka
opm	I	Oksapmin
opo	I	Opao
opt	I	Opata
opy	I	Ofayé
ora	I	Oroha
orc	I	Orma
ore	I	Orejón
org	I	Oring
orh	I	Oroqen
ori	M	Oriya (macrolanguage)
orm	M	Oromo
orn	I	Orang Kanaq
oro	I	Orokolo
orr	I	Oruma
ors	I	Orang Seletar
ort	I	Adivasi Oriya
oru	I	Ormuri
orv	I	Old Russian
orw	I	Oro Win
orx	I	Oro
ory	I	Odia
orz	I	Ormu
osa	I	Osage
osc	I	Oscan
osi	I	Osing
osn	I	Old Sundanese
oso	I	Ososo
osp	I	Old Spanish
oss	I	Ossetian
ost	I	Osatu
osu	I	Southern One
osx	I	Old Saxon
ota	I	Ottoman Turkish (1500-1928)
otb	I	Old Tibetan
otd	I	Ot Danum
ote	I	Mezquital Otomi
oti	I	Oti
otk	I	Old Turkish
otl	I	Tilapa Otomi
otm	I	Eastern Highland Otomi
otn	I	Tenango Otomi
otq	I	Querétaro Otomi
otr	I	Otoro
ots	I	Estado de México Otomi
ott	I	Temoaya Otomi
otu	I	Otuke
otw	I	Ottawa
otx	I	Texcatepec Otomi
oty	I	Old Tamil
otz	I	Ixtenco Otomi
oua	I	Tagargrent
oub	I	Glio-Oubi
oue	I	Oune
oui	I	Old Uighur
oum	I	Ouma
ovd	I	Elfdalian
owi	I	Owiniga
owl	I	Old Welsh
oyb	I	Oy
oyd	I	Oyda
oym	I	Wayampi
oyy	I	Oya'oya
ozm	I	Koonzime
pab	I	Parecís
pac	I	Pacoh
pad	I	Paumarí
pae	I	Pagibete
paf	I	Paranawát
pag	I	Pangasinan
pah	I	Tenharim
pai	I	Pe
pak	I	Parakanã
pal	I	Pahlavi
pam	I	Pampanga
pan	I	Panjabi
pao	I	Northern Paiute
pap	I	Papiamento
paq	I	Parya
par	I	Panamint
pas	I	Papasena
pau	I	Palauan
pav	I	Pakaásnovos
paw	I	Pawnee
pax	I	Pankararé
pay	I	Pech
paz	I	Pankararú
pbb	I	Páez
pbc	I	Patamona
pbe	I	Mezontla Popoloca
pbf	I	Coyotepec Popoloca
pbg	I	Paraujano
pbh	I	E'ñapa Woromaipu
pbi	I	Parkwa
pbl	I	Mak (Nigeria)
pbm	I	Puebla Mazatec
pbn	I	Kpasam
pbo	I	Papel
pbp	I	Badyara
pbr	I	Pangwa
pbs	I	Central Pame
pbt	I	Southern Pashto
pbu	I	Northern Pashto
pbv	I	Pnar
pby	I	Pyu (Papua New Guinea)
pca	I	Santa Inés Ahuatempan Popoloca
pcb	I	Pear
pcc	I	Bouyei
pcd	I	Picard
pce	I	Ruching Palaung
pcf	I	Paliyan
pcg	I	Paniya
pch	I	Pardhan
pci	I	Duruwa
pcj	I	Parenga
pck	I	Paite Chin
pcl	I	Pardhi
pcm	I	Nigerian Pidgin
pcn	I	Piti
pcp	I	Pacahuara
pcw	I	Pyapun
pda	I	Anam
pdc	I	Pennsylvania German
pdi	I	Pa Di
pdn	I	Podena
pdo	I	Padoe
pdt	I	Plautdietsch
pdu	I	Kayan
pea	I	Peranakan Indonesian
peb	I	Eastern Pomo
ped	I	Mala (Papua New Guinea)
pee	I	Taje
pef	I	Northeastern Pomo
peg	I	Pengo
peh	I	Bonan
pei	I	Chichimeca-Jonaz
pej	I	Northern Pomo
pek	I	Penchal
pel	I	Pekal
pem	I	Phende
peo	I	Old Persian (ca. 600-400 B.C.)
pep	I	Kunja
peq	I	Southern Pomo
pes	I	Iranian Persian
pev	I	Pémono
pex	I	Petats
pey	I	Petjo
pez	I	Eastern Penan
pfa	I	Pááfang
pfe	I	Pere
pfl	I	Pfaelzisch
pga	I	Sudanese Creole Arabic
pgd	I	Gāndhārī
pgg	I	Pangwali
pgi	I	Pagi
pgk	I	Rerep
pgl	I	Primitive Irish
pgn	I	Paelignian
pgs	I	Pangseng
pgu	I	Pagu
pgz	I	Papua New Guinean Sign Language
pha	I	Pa-Hng
phd	I	Phudagi
phg	I	Phuong
phh	I	Phukha
phj	I	Pahari
phk	I	Phake
phl	I	Phalura
phm	I	Phimbi
phn	I	Phoenician
pho	I	Phunoi
phq	I	Phana'
phr	I	Pahari-Potwari
pht	I	Phu Thai
phu	I	Phuan
phv	I	Pahlavani
phw	I	Phangduwali
pia	I	Pima Bajo
pib	I	Yine
pic	I	Pinji
pid	I	Piaroa
pie	I	Piro
pif	I	Pingelapese
pig	I	Pisabo
pih	I	Pitcairn-Norfolk
pij	I	Pijao
pil	I	Yom
pim	I	Powhatan
pin	I	Piame
pio	I	Piapoco
pip	I	Pero
pir	I	Piratapuyo
pis	I	Pijin
pit	I	Pitta Pitta
piu	I	Pintupi-Luritja
piv	I	Pileni
piw	I	Pimbwe
pix	I	Piu
piy	I	Piya-Kwonci
piz	I	Pije
pjt	I	Pitjantjatjara
pka	I	Ardhamāgadhī Prākrit
pkb	I	Pokomo
pkc	I	Paekche
pkg	I	Pak-Tong
pkh	I	Pankhu
pkn	I	Pakanha
pko	I	Pökoot
pkp	I	Pukapuka
pkr	I	Attapady Kurumba
pks	I	Pakistan Sign Language
pkt	I	Maleng
pku	I	Paku
pla	I	Miani
plb	I	Polonombauk
plc	I	Central Palawano
pld	I	Polari
ple	I	Palu'e
plg	I	Pilagá
plh	I	Paulohi
pli	I	Pali
plk	I	Kohistani Shina
pll	I	Shwe Palaung
pln	I	Palenquero
plo	I	Oluta Popoluca
plq	I	Palaic
plr	I	Palaka Senoufo
pls	I	San Marcos Tlacoyalco Popoloca
plt	I	Plateau Malagasy
plu	I	Palikúr
plv	I	Southwest Palawano
plw	I	Brooke's Point Palawano
ply	I	Bolyu
plz	I	Paluan
pma	I	Paama
pmb	I	Pambia
pmd	I	Pallanganmiddang
pme	I	Pwaamei
pmf	I	Pamona
pmh	I	Māhārāṣṭri Prākrit
pmi	I	Northern Pumi
pmj	I	Southern Pumi
pml	I	Lingua Franca
pmm	I	Pomo
pmn	I	Pam
pmo	I	Pom
pmq	I	Northern Pame
pmr	I	Paynamar
pms	I	Piemontese
pmt	I	Tuamotuan
pmw	I	Plains Miwok
pmx	I	Poumei Naga
pmy	I	Papuan Malay
pmz	I	Southern Pame
pna	I	Punan Bah-Biau
pnb	I	Western Panjabi
pnc	I	Pannei
pnd	I	Mpinda
pne	I	Western Penan
png	I	Pangu
pnh	I	Penrhyn
pni	I	Aoheng
pnj	I	Pinjarup
pnk	I	Paunaka
pnl	I	Paleni
pnm	I	Punan Batu 1
pnn	I	Pinai-Hagahai
pno	I	Panobo
pnp	I	Pancana
pnq	I	Pana (Burkina Faso)
pnr	I	Panim
pns	I	Ponosakan
pnt	I	Pontic
pnu	I	Jiongnai Bunu
pnv	I	Pinigura
pnw	I	Banyjima
pnx	I	Phong-Kniang
pny	I	Pinyin
pnz	I	Pana (Central African Republic)
poc	I	Poqomam
poe	I	San Juan Atzingo Popoloca
pof	I	Poke
pog	I	Potiguára
poh	I	Poqomchi'
poi	I	Highland Popoluca
pok	I	Pokangá
pol	I	Polish
pom	I	Southeastern Pomo
pon	I	Pohnpeian
poo	I	Central Pomo
pop	I	Pwapwâ
poq	I	Texistepec Popoluca
por	I	Portuguese
pos	I	Sayula Popoluca
pot	I	Potawatomi
pov	I	Upper Guinea Crioulo
pow	I	San Felipe Otlaltepec Popoloca
pox	I	Polabian
poy	I	Pogolo
ppe	I	Papi
ppi	I	Paipai
ppk	I	Uma
ppl	I	Pipil
ppm	I	Papuma
ppn	I	Papapana
ppo	I	Folopa
ppp	I	Pelende
ppq	I	Pei
pps	I	San Luís Temalacayuca Popoloca
ppt	I	Pare
ppu	I	Papora
pqa	I	Pa'a
pqm	I	Malecite-Passamaquoddy
prc	I	Parachi
prd	I	Parsi-Dari
pre	I	Principense
prf	I	Paranan
prg	I	Prussian
prh	I	Porohanon
pri	I	Paicî
prk	I	Parauk
prl	I	Peruvian Sign Language
prm	I	Kibiri
prn	I	Prasuni
pro	I	Old Provençal (to 1500)
prq	I	Ashéninka Perené
prr	I	Puri
prs	I	Dari
prt	I	Phai
pru	I	Puragi
prw	I	Parawen
prx	I	Purik
prz	I	Providencia Sign Language
psa	I	Asue Awyu
psc	I	Iranian Sign Language
psd	I	Plains Indian Sign Language
pse	I	Central Malay
psg	I	Penang Sign Language
psh	I	Southwest Pashai
psi	I	Southeast Pashai
psl	I	Puerto Rican Sign Language
psm	I	Pauserna
psn	I	Panasuan
pso	I	Polish Sign Language
psp	I	Philippine Sign Language
psq	I	Pasi
psr	I	Portuguese Sign Language
pss	I	Kaulong
pst	I	Central Pashto
psu	I	Sauraseni Prākrit
psw	I	Port Sandwich
psy	I	Piscataway
pta	I	Pai Tavytera
pth	I	Pataxó Hã-Ha-Hãe
pti	I	Pindiini
ptn	I	Patani
pto	I	Zo'é
ptp	I	Patep
ptq	I	Pattapu
ptr	I	Piamatsina
ptt	I	Enrekang
ptu	I	Bambam
ptv	I	Port Vato
ptw	I	Pentlatch
pty	I	Pathiya
pua	I	Western Highland Purepecha
pub	I	Purum
puc	I	Punan Merap
pud	I	Punan Aput
pue	I	Puelche
puf	I	Punan Merah
pug	I	Phuie
pui	I	Puinave
puj	I	Punan Tubu
pum	I	Puma
puo	I	Puoc
pup	I	Pulabu
puq	I	Puquina
pur	I	Puruborá
pus	M	Pushto
put	I	Putoh
puu	I	Punu
puw	I	Puluwatese
pux	I	Puare
puy	I	Purisimeño
pwa	I	Pawaia
pwb	I	Panawa
pwg	I	Gapapaiwa
pwi	I	Patwin
pwm	I	Molbog
pwn	I	Paiwan
pwo	I	Pwo Western Karen
pwr	I	Powari
pww	I	Pwo Northern Karen
pxm	I	Quetzaltepec Mixe
pye	I	Pye Krumen
pym	I	Fyam
pyn	I	Poyanáwa
pys	I	Paraguayan Sign Language
pyu	I	Puyuma
pyx	I	Pyu (Myanmar)
pyy	I	Pyen
pze	I	Pesse
pzh	I	Pazeh
pzn	I	Jejara Naga
qua	I	Quapaw
qub	I	Huallaga Huánuco Quechua
quc	I	K'iche'
qud	I	Calderón Highland Quichua
que	M	Quechua
quf	I	Lambayeque Quechua
qug	I	Chimborazo Highland Quichua
quh	I	South Bolivian Quechua
qui	I	Quileute
quk	I	Chachapoyas Quechua
qul	I	North Bolivian Quechua
qum	I	Sipacapense
qun	I	Quinault
qup	I	Southern Pastaza Quechua
quq	I	Quinqui
qur	I	Yanahuanca Pasco Quechua
qus	I	Santiago del Estero Quichua
quv	I	Sacapulteco
quw	I	Tena Lowland Quichua
qux	I	Yauyos Quechua
quy	I	Ayacucho Quechua
quz	I	Cusco Quechua
qva	I	Ambo-Pasco Quechua
qvc	I	Cajamarca Quechua
qve	I	Eastern Apurímac Quechua
qvh	I	Huamalíes-Dos de Mayo Huánuco Quechua
qvi	I	Imbabura Highland Quichua
qvj	I	Loja Highland Quichua
qvl	I	Cajatambo North Lima Quechua
qvm	I	Margos-Yarowilca-Lauricocha Quechua
qvn	I	North Junín Quechua
qvo	I	Napo Lowland Quechua
qvp	I	Pacaraos Quechua
qvs	I	San Martín Quechua
qvw	I	Huaylla Wanca Quechua
qvy	I	Queyu
qvz	I	Northern Pastaza Quichua
qwa	I	Corongo Ancash Quechua
qwc	I	Classical Quechua
qwh	I	Huaylas Ancash Quechua
qwm	I	Kuman (Russia)
qws	I	Sihuas Ancash Quechua
qwt	I	Kwalhioqua-Tlatskanai
qxa	I	Chiquián Ancash Quechua
qxc	I	Chincha Quechua
qxh	I	Panao Huánuco Quechua
qxl	I	Salasaca Highland Quichua
qxn	I	Northern Conchucos Ancash Quechua
qxo	I	Southern Conchucos Ancash Quechua
qxp	I	Puno Quechua
qxq	I	Qashqa'i
qxr	I	Cañar Highland Quichua
qxs	I	Southern Qiang
qxt	I	Santa Ana de Tusi Pasco Quechua
qxu	I	Arequipa-La Unión Quechua
qxw	I	Jauja Wanca Quechua
qya	I	Quenya
qyp	I	Quiripi
raa	I	Dungmali
rab	I	Camling
rac	I	Rasawa
rad	I	Rade
raf	I	Western Meohang
rag	I	Logooli
rah	I	Rabha
rai	I	Ramoaaina
raj	M	Rajasthani
rak	I	Tulu-Bohuai
ral	I	Ralte
ram	I	Canela
ran	I	Riantana
rao	I	Rao
rap	I	Rapanui
raq	I	Saam
rar	I	Rarotongan
ras	I	Tegali
rat	I	Razajerdi
rau	I	Raute
rav	I	Sampang
raw	I	Rawang
rax	I	Rang
ray	I	Rapa
raz	I	Rahambuu
rbb	I	Rumai Palaung
rbk	I	Northern Bontok
rbl	I	Miraya Bikol
rbp	I	Barababaraba
rcf	I	Réunion Creole French
rdb	I	Rudbari
rea	I	Rerau
reb	I	Rembong
ree	I	Rejang Kayan
reg	I	Kara (Tanzania)
rei	I	Reli
rej	I	Rejang
rel	I	Rendille
rem	I	Remo
ren	I	Rengao
rer	I	Rer Bare
res	I	Reshe
ret	I	Retta
rey	I	Reyesano
rga	I	Roria
rge	I	Romano-Greek
rgk	I	Rangkas
rgn	I	Romagnol
rgr	I	Resígaro
rgs	I	Southern Roglai
rgu	I	Ringgou
rhg	I	Rohingya
rhp	I	Yahang
ria	I	Riang (India)
rib	I	Bribri Sign Language
rif	I	Tarifit
ril	I	Riang Lang
rim	I	Nyaturu
rin	I	Nungu
rir	I	Ribun
rit	I	Ritharrngu
riu	I	Riung
rjg	I	Rajong
rji	I	Raji
rjs	I	Rajbanshi
rka	I	Kraol
rkb	I	Rikbaktsa
rkh	I	Rakahanga-Manihiki
rki	I	Rakhine
rkm	I	Marka
rkt	I	Rangpuri
rkw	I	Arakwal
rma	I	Rama
rmb	I	Rembarrnga
rmc	I	Carpathian Romani
rmd	I	Traveller Danish
rme	I	Angloromani
rmf	I	Kalo Finnish Romani
rmg	I	Traveller Norwegian
rmh	I	Murkim
rmi	I	Lomavren
rmk	I	Romkun
rml	I	Baltic Romani
rmm	I	Roma
rmn	I	Balkan Romani
rmo	I	Sinte Romani
rmp	I	Rempi
rmq	I	Caló
rms	I	Romanian Sign Language
rmt	I	Domari
rmu	I	Tavringer Romani
rmv	I	Romanova
rmw	I	Welsh Romani
rmx	I	Romam
rmy	I	Vlax Romani
rmz	I	Marma
rnb	I	Brunca Sign Language
rnd	I	Ruund
rng	I	Ronga
rnl	I	Ranglong
rnn	I	Roon
rnp	I	Rongpo
rnr	I	Nari Nari
rnw	I	Rungwa
rob	I	Tae'
roc	I	Cacgia Roglai
rod	I	Rogo
roe	I	Ronji
rof	I	Rombo
rog	I	Northern Roglai
roh	I	Romansh
rol	I	Romblomanon
rom	M	Romany
ron	I	Romanian
roo	I	Rotokas
rop	I	Kriol
ror	I	Rongga
rou	I	Runga
row	I	Dela-Oenale
rpn	I	Repanbitip
rpt	I	Rapting
rri	I	Ririo
rrm	I	Moriori
rro	I	Waima
rrt	I	Arritinngithigh
rsb	I	Romano-Serbian
rsk	I	Ruthenian
rsl	I	Russian Sign Language
rsm	I	Miriwoong Sign Language
rsn	I	Rwandan Sign Language
rsw	I	Rishiwa
rtc	I	Rungtu Chin
rth	I	Ratahan
rtm	I	Rotuman
rts	I	Yurats
rtw	I	Rathawi
rub	I	Gungu
ruc	I	Ruuli
rue	I	Rusyn
ruf	I	Luguru
rug	I	Roviana
ruh	I	Ruga
rui	I	Rufiji
ruk	I	Che
run	I	Rundi
ruo	I	Istro Romanian
rup	I	Macedo-Romanian
ruq	I	Megleno Romanian
rus	I	Russian
rut	I	Rutul
ruu	I	Lanas Lobu
ruy	I	Mala (Nigeria)
ruz	I	Ruma
rwa	I	Rawo
rwk	I	Rwa
rwl	I	Ruwila
rwm	I	Amba (Uganda)
rwo	I	Rawa
rwr	I	Marwari (India)
rxd	I	Ngardi
rxw	I	Karuwali
ryn	I	Northern Amami-Oshima
rys	I	Yaeyama
ryu	I	Central Okinawan
rzh	I	Rāziḥī
saa	I	Saba
sab	I	Buglere
sac	I	Meskwaki
sad	I	Sandawe
sae	I	Sabanê
saf	I	Safaliba
sag	I	Sango
sah	I	Yakut
saj	I	Sahu
sak	I	Sake
sam	I	Samaritan Aramaic
san	M	Sanskrit
sao	I	Sause
saq	I	Samburu
sar	I	Saraveca
sas	I	Sasak
sat	I	Santali
sau	I	Saleman
sav	I	Saafi-Saafi
saw	I	Sawi
sax	I	Sa
say	I	Saya
saz	I	Saurashtra
sba	I	Ngambay
sbb	I	Simbo
sbc	I	Kele (Papua New Guinea)
sbd	I	Southern Samo
sbe	I	Saliba
sbf	I	Chabu
sbg	I	Seget
sbh	I	Sori-Harengan
sbi	I	Seti
sbj	I	Surbakhal
sbk	I	Safwa
sbl	I	Botolan Sambal
sbm	I	Sagala
sbn	I	Sindhi Bhil
sbo	I	Sabüm
sbp	I	Sangu (Tanzania)
sbq	I	Sileibi
sbr	I	Sembakung Murut
sbs	I	Subiya
sbt	I	Kimki
sbu	I	Stod Bhoti
sbv	I	Sabine
sbw	I	Simba
sbx	I	Seberuang
sby	I	Soli
sbz	I	Sara Kaba
scb	I	Chut
sce	I	Dongxiang
scf	I	San Miguel Creole French
scg	I	Sanggau
sch	I	Sakachep
sci	I	Sri Lankan Creole Malay
sck	I	Sadri
scl	I	Shina
scn	I	Sicilian
sco	I	Scots
scp	I	Hyolmo
scq	I	Sa'och
scs	I	North Slavey
sct	I	Southern Katang
scu	I	Shumcho
scv	I	Sheni
scw	I	Sha
scx	I	Sicel
sda	I	Toraja-Sa'dan
sdb	I	Shabak
sdc	I	Sassarese Sardinian
sde	I	Surubu
sdf	I	Sarli
sdg	I	Savi
sdh	I	Southern Kurdish
sdj	I	Suundi
sdk	I	Sos Kundi
sdl	I	Saudi Arabian Sign Language
sdn	I	Gallurese Sardinian
sdo	I	Bukar-Sadung Bidayuh
sdp	I	Sherdukpen
sdq	I	Semandang
sdr	I	Oraon Sadri
sds	I	Sened
sdt	I	Shuadit
sdu	I	Sarudu
sdx	I	Sibu Melanau
sdz	I	Sallands
sea	I	Semai
seb	I	Shempire Senoufo
sec	I	Sechelt
sed	I	Sedang
see	I	Seneca
sef	I	Cebaara Senoufo
seg	I	Segeju
seh	I	Sena
sei	I	Seri
sej	I	Sene
sek	I	Sekani
sel	I	Selkup
sen	I	Nanerigé Sénoufo
seo	I	Suarmin
sep	I	Sìcìté Sénoufo
seq	I	Senara Sénoufo
ser	I	Serrano
ses	I	Koyraboro Senni Songhai
set	I	Sentani
seu	I	Serui-Laut
sev	I	Nyarafolo Senoufo
sew	I	Sewa Bay
sey	I	Secoya
sez	I	Senthang Chin
sfb	I	Langue des signes de Belgique Francophone
sfe	I	Eastern Subanen
sfm	I	Small Flowery Miao
sfs	I	South African Sign Language
sfw	I	Sehwi
sga	I	Old Irish (to 900)
sgb	I	Mag-antsi Ayta
sgc	I	Kipsigis
sgd	I	Surigaonon
sge	I	Segai
sgg	I	Swiss-German Sign Language
sgh	I	Shughni
sgi	I	Suga
sgj	I	Surgujia
sgk	I	Sangkong
sgm	I	Singa
sgp	I	Singpho
sgr	I	Sangisari
sgs	I	Samogitian
sgt	I	Brokpake
sgu	I	Salas
sgw	I	Sebat Bet Gurage
sgx	I	Sierra Leone Sign Language
sgy	I	Sanglechi
sgz	I	Sursurunga
sha	I	Shall-Zwall
shb	I	Ninam
shc	I	Sonde
shd	I	Kundal Shahi
she	I	Sheko
shg	I	Shua
shh	I	Shoshoni
shi	I	Tachelhit
shj	I	Shatt
shk	I	Shilluk
shl	I	Shendu
shm	I	Shahrudi
shn	I	Shan
sho	I	Shanga
shp	I	Shipibo-Conibo
shq	I	Sala
shr	I	Shi
shs	I	Shuswap
sht	I	Shasta
shu	I	Chadian Arabic
shv	I	Shehri
shw	I	Shwai
shx	I	She
shy	I	Tachawit
shz	I	Syenara Senoufo
sia	I	Akkala Sami
sib	I	Sebop
sid	I	Sidamo
sie	I	Simaa
sif	I	Siamou
sig	I	Paasaal
sih	I	Zire
sii	I	Shom Peng
sij	I	Numbami
sik	I	Sikiana
sil	I	Tumulung Sisaala
sim	I	Mende (Papua New Guinea)
sin	I	Sinhala
sip	I	Sikkimese
siq	I	Sonia
sir	I	Siri
sis	I	Siuslaw
siu	I	Sinagen
siv	I	Sumariup
siw	I	Siwai
six	I	Sumau
siy	I	Sivandi
siz	I	Siwi
sja	I	Epena
sjb	I	Sajau Basap
sjc	I	Shaojiang Chinese
sjd	I	Kildin Sami
sje	I	Pite Sami
sjg	I	Assangori
sjk	I	Kemi Sami
sjl	I	Sajalong
sjm	I	Mapun
sjn	I	Sindarin
sjo	I	Xibe
sjp	I	Surjapuri
sjr	I	Siar-Lak
sjs	I	Senhaja De Srair
sjt	I	Ter Sami
sju	I	Ume Sami
sjw	I	Shawnee
ska	I	Skagit
skb	I	Saek
skc	I	Ma Manda
skd	I	Southern Sierra Miwok
ske	I	Seke (Vanuatu)
skf	I	Sakirabiá
skg	I	Sakalava Malagasy
skh	I	Sikule
ski	I	Sika
skj	I	Seke (Nepal)
skm	I	Kutong
skn	I	Kolibugan Subanon
sko	I	Seko Tengah
skp	I	Sekapan
skq	I	Sininkere
skr	I	Saraiki
sks	I	Maia
skt	I	Sakata
sku	I	Sakao
skv	I	Skou
skw	I	Skepi Creole Dutch
skx	I	Seko Padang
sky	I	Sikaiana
skz	I	Sekar
slc	I	Sáliba
sld	I	Sissala
sle	I	Sholaga
slf	I	Swiss-Italian Sign Language
slg	I	Selungai Murut
slh	I	Southern Puget Sound Salish
sli	I	Lower Silesian
slj	I	Salumá
slk	I	Slovak
sll	I	Salt-Yui
slm	I	Pangutaran Sama
sln	I	Salinan
slp	I	Lamaholot
slr	I	Salar
sls	I	Singapore Sign Language
slt	I	Sila
slu	I	Selaru
slv	I	Slovenian
slw	I	Sialum
slx	I	Salampasu
sly	I	Selayar
slz	I	Ma'ya
sma	I	Southern Sami
smb	I	Simbari
smc	I	Som
sme	I	Northern Sami
smf	I	Auwe
smg	I	Simbali
smh	I	Samei
smj	I	Lule Sami
smk	I	Bolinao
sml	I	Central Sama
smm	I	Musasa
smn	I	Inari Sami
smo	I	Samoan
smp	I	Samaritan
smq	I	Samo
smr	I	Simeulue
sms	I	Skolt Sami
smt	I	Simte
smu	I	Somray
smv	I	Samvedi
smw	I	Sumbawa
smx	I	Samba
smy	I	Semnani
smz	I	Simeku
sna	I	Shona
snc	I	Sinaugoro
snd	I	Sindhi
sne	I	Bau Bidayuh
snf	I	Noon
sng	I	Sanga (Democratic Republic of Congo)
sni	I	Sensi
snj	I	Riverain Sango
snk	I	Soninke
snl	I	Sangil
snm	I	Southern Ma'di
snn	I	Siona
sno	I	Snohomish
snp	I	Siane
snq	I	Sangu (Gabon)
snr	I	Sihan
sns	I	South West Bay
snu	I	Senggi
snv	I	Sa'ban
snw	I	Selee
snx	I	Sam
sny	I	Saniyo-Hiyewe
snz	I	Kou
soa	I	Thai Song
sob	I	Sobei
soc	I	So (Democratic Republic of Congo)
sod	I	Songoora
soe	I	Songomeno
sog	I	Sogdian
soh	I	Aka
soi	I	Sonha
soj	I	Soi
sok	I	Sokoro
sol	I	Solos
som	I	Somali
soo	I	Songo
sop	I	Songe
soq	I	Kanasi
sor	I	Somrai
sos	I	Seeku
sot	I	Southern Sotho
sou	I	Southern Thai
sov	I	Sonsorol
sow	I	Sowanda
sox	I	Swo
soy	I	Miyobe
soz	I	Temi
spa	I	Spanish
spb	I	Sepa (Indonesia)
spc	I	Sapé
spd	I	Saep
spe	I	Sepa (Papua New Guinea)
spg	I	Sian
spi	I	Saponi
spk	I	Sengo
spl	I	Selepet
spm	I	Akukem
spn	I	Sanapaná
spo	I	Spokane
spp	I	Supyire Senoufo
spq	I	Loreto-Ucayali Spanish
spr	I	Saparua
sps	I	Saposa
spt	I	Spiti Bhoti
spu	I	Sapuan
spv	I	Sambalpuri
spx	I	South Picene
spy	I	Sabaot
sqa	I	Shama-Sambuga
sqh	I	Shau
sqi	M	Albanian
sqk	I	Albanian Sign Language
sqm	I	Suma
sqn	I	Susquehannock
sqo	I	Sorkhei
sqq	I	Sou
sqr	I	Siculo Arabic
sqs	I	Sri Lankan Sign Language
sqt	I	Soqotri
squ	I	Squamish
sqx	I	Kufr Qassem Sign Language (KQSL)
sra	I	Saruga
srb	I	Sora
src	I	Logudorese Sardinian
srd	M	Sardinian
sre	I	Sara
srf	I	Nafi
srg	I	Sulod
srh	I	Sarikoli
sri	I	Siriano
srk	I	Serudung Murut
srl	I	Isirawa
srm	I	Saramaccan
srn	I	Sranan Tongo
sro	I	Campidanese Sardinian
srp	I	Serbian
srq	I	Sirionó
srr	I	Serer
srs	I	Sarsi
srt	I	Sauri
sru	I	Suruí
srv	I	Southern Sorsoganon
srw	I	Serua
srx	I	Sirmauri
sry	I	Sera
srz	I	Shahmirzadi
ssb	I	Southern Sama
ssc	I	Suba-Simbiti
ssd	I	Siroi
sse	I	Balangingi
ssf	I	Thao
ssg	I	Seimat
ssh	I	Shihhi Arabic
ssi	I	Sansi
ssj	I	Sausi
ssk	I	Sunam
ssl	I	Western Sisaala
ssm	I	Semnam
ssn	I	Waata
sso	I	Sissano
ssp	I	Spanish Sign Language
ssq	I	So'a
ssr	I	Swiss-French Sign Language
sss	I	Sô
sst	I	Sinasina
ssu	I	Susuami
ssv	I	Shark Bay
ssw	I	Swati
ssx	I	Samberigi
ssy	I	Saho
ssz	I	Sengseng
sta	I	Settla
stb	I	Northern Subanen
std	I	Sentinel
ste	I	Liana-Seti
stf	I	Seta
stg	I	Trieng
sth	I	Shelta
sti	I	Bulo Stieng
stj	I	Matya Samo
stk	I	Arammba
stl	I	Stellingwerfs
stm	I	Setaman
stn	I	Owa
sto	I	Stoney
stp	I	Southeastern Tepehuan
stq	I	Saterfriesisch
str	I	Straits Salish
sts	I	Shumashti
stt	I	Budeh Stieng
stu	I	Samtao
stv	I	Silt'e
stw	I	Satawalese
sty	I	Siberian Tatar
sua	I	Sulka
sub	I	Suku
suc	I	Western Subanon
sue	I	Suena
sug	I	Suganga
sui	I	Suki
suj	I	Shubi
suk	I	Sukuma
sun	I	Sundanese
suo	I	Bouni
suq	I	Tirmaga-Chai Suri
sur	I	Mwaghavul
sus	I	Susu
sut	I	Subtiaba
suv	I	Puroik
suw	I	Sumbwa
sux	I	Sumerian
suy	I	Suyá
suz	I	Sunwar
sva	I	Svan
svb	I	Ulau-Suain
svc	I	Vincentian Creole English
sve	I	Serili
svk	I	Slovakian Sign Language
svm	I	Slavomolisano
svs	I	Savosavo
svx	I	Skalvian
swa	M	Swahili (macrolanguage)
swb	I	Maore Comorian
swc	I	Congo Swahili
swe	I	Swedish
swf	I	Sere
swg	I	Swabian
swh	I	Swahili (individual language)
swi	I	Sui
swj	I	Sira
swk	I	Malawi Sena
swl	I	Swedish Sign Language
swm	I	Samosa
swn	I	Sawknah
swo	I	Shanenawa
swp	I	Suau
swq	I	Sharwa
swr	I	Saweru
sws	I	Seluwasan
swt	I	Sawila
swu	I	Suwawa
swv	I	Shekhawati
sww	I	Sowa
swx	I	Suruahá
swy	I	Sarua
sxb	I	Suba
sxc	I	Sicanian
sxe	I	Sighu
sxg	I	Shuhi
sxk	I	Southern Kalapuya
sxl	I	Selian
sxm	I	Samre
sxn	I	Sangir
sxo	I	Sorothaptic
sxr	I	Saaroa
sxs	I	Sasaru
sxu	I	Upper Saxon
sxw	I	Saxwe Gbe
sya	I	Siang
syb	I	Central Subanen
syc	I	Classical Syriac
syi	I	Seki
syk	I	Sukur
syl	I	Sylheti
sym	I	Maya Samo
syn	I	Senaya
syo	I	Suoy
syr	M	Syriac
sys	I	Sinyar
syw	I	Kagate
syx	I	Samay
syy	I	Al-Sayyid Bedouin Sign Language
sza	I	Semelai
szb	I	Ngalum
szc	I	Semaq Beri
sze	I	Seze
szg	I	Sengele
szl	I	Silesian
szn	I	Sula
szp	I	Suabo
szs	I	Solomon Islands Sign Language
szv	I	Isu (Fako Division)
szw	I	Sawai
szy	I	Sakizaya
taa	I	Lower Tanana
tab	I	Tabassaran
tac	I	Lowland Tarahumara
tad	I	Tause
tae	I	Tariana
taf	I	Tapirapé
tag	I	Tagoi
tah	I	Tahitian
taj	I	Eastern Tamang
tak	I	Tala
tal	I	Tal
tam	I	Tamil
tan	I	Tangale
tao	I	Yami
tap	I	Taabwa
taq	I	Tamasheq
tar	I	Central Tarahumara
tas	I	Tay Boi
tat	I	Tatar
tau	I	Upper Tanana
tav	I	Tatuyo
taw	I	Tai
tax	I	Tamki
tay	I	Atayal
taz	I	Tocho
tba	I	Aikanã
tbc	I	Takia
tbd	I	Kaki Ae
tbe	I	Tanimbili
tbf	I	Mandara
tbg	I	North Tairora
tbh	I	Dharawal
tbi	I	Gaam
tbj	I	Tiang
tbk	I	Calamian Tagbanwa
tbl	I	Tboli
tbm	I	Tagbu
tbn	I	Barro Negro Tunebo
tbo	I	Tawala
tbp	I	Taworta
tbr	I	Tumtum
tbs	I	Tanguat
tbt	I	Tembo (Kitembo)
tbu	I	Tubar
tbv	I	Tobo
tbw	I	Tagbanwa
tbx	I	Kapin
tby	I	Tabaru
tbz	I	Ditammari
tca	I	Ticuna
tcb	I	Tanacross
tcc	I	Datooga
tcd	I	Tafi
tce	I	Southern Tutchone
tcf	I	Malinaltepec Me'phaa
tcg	I	Tamagario
tch	I	Turks And Caicos Creole English
tci	I	Wára
tck	I	Tchitchege
tcl	I	Taman (Myanmar)
tcm	I	Tanahmerah
tcn	I	Tichurong
tco	I	Taungyo
tcp	I	Tawr Chin
tcq	I	Kaiy
tcs	I	Torres Strait Creole
tct	I	T'en
tcu	I	Southeastern Tarahumara
tcw	I	Tecpatlán Totonac
tcx	I	Toda
tcy	I	Tulu
tcz	I	Thado Chin
tda	I	Tagdal
tdb	I	Panchpargania
tdc	I	Emberá-Tadó
tdd	I	Tai Nüa
tde	I	Tiranige Diga Dogon
tdf	I	Talieng
tdg	I	Western Tamang
tdh	I	Thulung
tdi	I	Tomadino
tdj	I	Tajio
tdk	I	Tambas
tdl	I	Sur
tdm	I	Taruma
tdn	I	Tondano
tdo	I	Teme
tdq	I	Tita
tdr	I	Todrah
tds	I	Doutai
tdt	I	Tetun Dili
tdv	I	Toro
tdx	I	Tandroy-Mahafaly Malagasy
tdy	I	Tadyawan
tea	I	Temiar
teb	I	Tetete
tec	I	Terik
ted	I	Tepo Krumen
tee	I	Huehuetla Tepehua
tef	I	Teressa
teg	I	Teke-Tege
teh	I	Tehuelche
tei	I	Torricelli
tek	I	Ibali Teke
tel	I	Telugu
tem	I	Timne
ten	I	Tama (Colombia)
teo	I	Teso
tep	I	Tepecano
teq	I	Temein
ter	I	Tereno
tes	I	Tengger
tet	I	Tetum
teu	I	Soo
tev	I	Teor
tew	I	Tewa (USA)
tex	I	Tennet
tey	I	Tulishi
tez	I	Tetserret
tfi	I	Tofin Gbe
tfn	I	Tanaina
tfo	I	Tefaro
tfr	I	Teribe
tft	I	Ternate
tga	I	Sagalla
tgb	I	Tobilung
tgc	I	Tigak
tgd	I	Ciwogai
tge	I	Eastern Gorkha Tamang
tgf	I	Chalikha
tgh	I	Tobagonian Creole English
tgi	I	Lawunuia
tgj	I	Tagin
tgk	I	Tajik
tgl	I	Tagalog
tgn	I	Tandaganon
tgo	I	Sudest
tgp	I	Tangoa
tgq	I	Tring
tgr	I	Tareng
tgs	I	Nume
tgt	I	Central Tagbanwa
tgu	I	Tanggu
tgv	I	Tingui-Boto
tgw	I	Tagwana Senoufo
tgx	I	Tagish
tgy	I	Togoyo
tgz	I	Tagalaka
tha	I	Thai
thd	I	Kuuk Thaayorre
the	I	Chitwania Tharu
thf	I	Thangmi
thh	I	Northern Tarahumara
thi	I	Tai Long
thk	I	Tharaka
thl	I	Dangaura Tharu
thm	I	Aheu
thn	I	Thachanadan
thp	I	Thompson
thq	I	Kochila Tharu
thr	I	Rana Tharu
ths	I	Thakali
tht	I	Tahltan
thu	I	Thuri
thv	I	Tahaggart Tamahaq
thy	I	Tha
thz	I	Tayart Tamajeq
tia	I	Tidikelt Tamazight
tic	I	Tira
tif	I	Tifal
tig	I	Tigre
tih	I	Timugon Murut
tii	I	Tiene
tij	I	Tilung
tik	I	Tikar
til	I	Tillamook
tim	I	Timbe
tin	I	Tindi
tio	I	Teop
tip	I	Trimuris
tiq	I	Tiéfo
tir	I	Tigrinya
tis	I	Masadiit Itneg
tit	I	Tinigua
tiu	I	Adasen
tiv	I	Tiv
tiw	I	Tiwi
tix	I	Southern Tiwa
tiy	I	Tiruray
tiz	I	Tai Hongjin
tja	I	Tajuasohn
tjg	I	Tunjung
tji	I	Northern Tujia
tjj	I	Tjungundji
tjl	I	Tai Laing
tjm	I	Timucua
tjn	I	Tonjon
tjo	I	Temacine Tamazight
tjp	I	Tjupany
tjs	I	Southern Tujia
tju	I	Tjurruru
tjw	I	Djabwurrung
tka	I	Truká
tkb	I	Buksa
tkd	I	Tukudede
tke	I	Takwane
tkf	I	Tukumanféd
tkg	I	Tesaka Malagasy
tkl	I	Tokelau
tkm	I	Takelma
tkn	I	Toku-No-Shima
tkp	I	Tikopia
tkq	I	Tee
tkr	I	Tsakhur
tks	I	Takestani
tkt	I	Kathoriya Tharu
tku	I	Upper Necaxa Totonac
tkv	I	Mur Pano
tkw	I	Teanu
tkx	I	Tangko
tkz	I	Takua
tla	I	Southwestern Tepehuan
tlb	I	Tobelo
tlc	I	Yecuatla Totonac
tld	I	Talaud
tlf	I	Telefol
tlg	I	Tofanma
tlh	I	Klingon
tli	I	Tlingit
tlj	I	Talinga-Bwisi
tlk	I	Taloki
tll	I	Tetela
tlm	I	Tolomako
tln	I	Talondo'
tlo	I	Talodi
tlp	I	Filomena Mata-Coahuitlán Totonac
tlq	I	Tai Loi
tlr	I	Talise
tls	I	Tambotalo
tlt	I	Sou Nama
tlu	I	Tulehu
tlv	I	Taliabu
tlx	I	Khehek
tly	I	Talysh
tma	I	Tama (Chad)
tmb	I	Katbol
tmc	I	Tumak
tmd	I	Haruai
tme	I	Tremembé
tmf	I	Toba-Maskoy
tmg	I	Ternateño
tmh	M	Tamashek
tmi	I	Tutuba
tmj	I	Samarokena
tml	I	Tamnim Citak
tmm	I	Tai Thanh
tmn	I	Taman (Indonesia)
tmo	I	Temoq
tmq	I	Tumleo
tmr	I	Jewish Babylonian Aramaic (ca. 200-1200 CE)
tms	I	Tima
tmt	I	Tasmate
tmu	I	Iau
tmv	I	Tembo (Motembo)
tmw	I	Temuan
tmy	I	Tami
tmz	I	Tamanaku
tna	I	Tacana
tnb	I	Western Tunebo
tnc	I	Tanimuca-Retuarã
tnd	I	Angosturas Tunebo
tng	I	Tobanga
tnh	I	Maiani
tni	I	Tandia
tnk	I	Kwamera
tnl	I	Lenakel
tnm	I	Tabla
tnn	I	North Tanna
tno	I	Toromono
tnp	I	Whitesands
tnq	I	Taino
tnr	I	Ménik
tns	I	Tenis
tnt	I	Tontemboan
tnu	I	Tay Khang
tnv	I	Tangchangya
tnw	I	Tonsawang
tnx	I	Tanema
tny	I	Tongwe
tnz	I	Ten'edn
tob	I	Toba
toc	I	Coyutla Totonac
tod	I	Toma
tof	I	Gizrra
tog	I	Tonga (Nyasa)
toh	I	Gitonga
toi	I	Tonga (Zambia)
toj	I	Tojolabal
tok	I	Toki Pona
tol	I	Tolowa
tom	I	Tombulu
ton	I	Tonga (Tonga Islands)
too	I	Xicotepec De Juárez Totonac
top	I	Papantla Totonac
toq	I	Toposa
tor	I	Togbo-Vara Banda
tos	I	Highland Totonac
tou	I	Tho
tov	I	Upper Taromi
tow	I	Jemez
tox	I	Tobian
toy	I	Topoiyo
toz	I	To
tpa	I	Taupota
tpc	I	Azoyú Me'phaa
tpe	I	Tippera
tpf	I	Tarpia
tpg	I	Kula
tpi	I	Tok Pisin
tpj	I	Tapieté
tpk	I	Tupinikin
tpl	I	Tlacoapa Me'phaa
tpm	I	Tampulma
tpn	I	Tupinambá
tpo	I	Tai Pao
tpp	I	Pisaflores Tepehua
tpq	I	Tukpa
tpr	I	Tuparí
tpt	I	Tlachichilco Tepehua
tpu	I	Tampuan
tpv	I	Tanapag
tpx	I	Acatepec Me'phaa
tpy	I	Trumai
tpz	I	Tinputz
tqb	I	Tembé
tql	I	Lehali
tqm	I	Turumsa
tqn	I	Tenino
tqo	I	Toaripi
tqp	I	Tomoip
tqq	I	Tunni
tqr	I	Torona
tqt	I	Western Totonac
tqu	I	Touo
tqw	I	Tonkawa
tra	I	Tirahi
trb	I	Terebu
trc	I	Copala Triqui
trd	I	Turi
tre	I	East Tarangan
trf	I	Trinidadian Creole English
trg	I	Lishán Didán
trh	I	Turaka
tri	I	Trió
trj	I	Toram
trl	I	Traveller Scottish
trm	I	Tregami
trn	I	Trinitario
tro	I	Tarao Naga
trp	I	Kok Borok
trq	I	San Martín Itunyoso Triqui
trr	I	Taushiro
trs	I	Chicahuaxtla Triqui
trt	I	Tunggare
tru	I	Turoyo
trv	I	Sediq
trw	I	Torwali
trx	I	Tringgus-Sembaan Bidayuh
try	I	Turung
trz	I	Torá
tsa	I	Tsaangi
tsb	I	Tsamai
tsc	I	Tswa
tsd	I	Tsakonian
tse	I	Tunisian Sign Language
tsg	I	Tausug
tsh	I	Tsuvan
tsi	I	Tsimshian
tsj	I	Tshangla
tsk	I	Tseku
tsl	I	Ts'ün-Lao
tsm	I	Turkish Sign Language
tsn	I	Tswana
tso	I	Tsonga
tsp	I	Northern Toussian
tsq	I	Thai Sign Language
tsr	I	Akei
tss	I	Taiwan Sign Language
tst	I	Tondi Songway Kiini
tsu	I	Tsou
tsv	I	Tsogo
tsw	I	Tsishingini
tsx	I	Mubami
tsy	I	Tebul Sign Language
tsz	I	Purepecha
tta	I	Tutelo
ttb	I	Gaa
ttc	I	Tektiteko
ttd	I	Tauade
tte	I	Bwanabwana
ttf	I	Tuotomb
ttg	I	Tutong
tth	I	Upper Ta'oih
tti	I	Tobati
ttj	I	Tooro
ttk	I	Totoro
ttl	I	Totela
ttm	I	Northern Tutchone
ttn	I	Towei
tto	I	Lower Ta'oih
ttp	I	Tombelala
ttq	I	Tawallammat Tamajaq
ttr	I	Tera
tts	I	Northeastern Thai
ttt	I	Muslim Tat
ttu	I	Torau
ttv	I	Titan
ttw	I	Long Wat
tty	I	Sikaritai
ttz	I	Tsum
tua	I	Wiarumus
tub	I	Tübatulabal
tuc	I	Mutu
tud	I	Tuxá
tue	I	Tuyuca
tuf	I	Central Tunebo
tug	I	Tunia
tuh	I	Taulil
tui	I	Tupuri
tuj	I	Tugutil
tuk	I	Turkmen
tul	I	Tula
tum	I	Tumbuka
tun	I	Tunica
tuo	I	Tucano
tuq	I	Tedaga
tur	I	Turkish
tus	I	Tuscarora
tuu	I	Tututni
tuv	I	Turkana
tux	I	Tuxináwa
tuy	I	Tugen
tuz	I	Turka
tva	I	Vaghua
tvd	I	Tsuvadi
tve	I	Te'un
tvi	I	Tulai
tvk	I	Southeast Ambrym
tvl	I	Tuvalu
tvm	I	Tela-Masbuar
tvn	I	Tavoyan
tvo	I	Tidore
tvs	I	Taveta
tvt	I	Tutsa Naga
tvu	I	Tunen
tvw	I	Sedoa
tvx	I	Taivoan
tvy	I	Timor Pidgin
twa	I	Twana
twb	I	Western Tawbuid
twc	I	Teshenawa
twd	I	Twents
twe	I	Tewa (Indonesia)
twf	I	Northern Tiwa
twg	I	Tereweng
twh	I	Tai Dón
twi	I	Twi
twl	I	Tawara
twm	I	Tawang Monpa
twn	I	Twendi
two	I	Tswapong
twp	I	Ere
twq	I	Tasawaq
twr	I	Southwestern Tarahumara
twt	I	Turiwára
twu	I	Termanu
tww	I	Tuwari
twx	I	Tewe
twy	I	Tawoyan
txa	I	Tombonuo
txb	I	Tokharian B
txc	I	Tsetsaut
txe	I	Totoli
txg	I	Tangut
txh	I	Thracian
txi	I	Ikpeng
txj	I	Tarjumo
txm	I	Tomini
txn	I	West Tarangan
txo	I	Toto
txq	I	Tii
txr	I	Tartessian
txs	I	Tonsea
txt	I	Citak
txu	I	Kayapó
txx	I	Tatana
txy	I	Tanosy Malagasy
tya	I	Tauya
tye	I	Kyanga
tyh	I	O'du
tyi	I	Teke-Tsaayi
tyj	I	Tai Do
tyl	I	Thu Lao
tyn	I	Kombai
typ	I	Thaypan
tyr	I	Tai Daeng
tys	I	Tày Sa Pa
tyt	I	Tày Tac
tyu	I	Kua
tyv	I	Tuvinian
tyx	I	Teke-Tyee
tyy	I	Tiyaa
tyz	I	Tày
tza	I	Tanzanian Sign Language
tzh	I	Tzeltal
tzj	I	Tz'utujil
tzl	I	Talossan
tzm	I	Central Atlas Tamazight
tzn	I	Tugun
tzo	I	Tzotzil
tzx	I	Tabriak
uam	I	Uamué
uan	I	Kuan
uar	I	Tairuma
uba	I	Ubang
ubi	I	Ubi
ubl	I	Buhi'non Bikol
ubr	I	Ubir
ubu	I	Umbu-Ungu
uby	I	Ubykh
uda	I	Uda
ude	I	Udihe
udg	I	Muduga
udi	I	Udi
udj	I	Ujir
udl	I	Wuzlam
udm	I	Udmurt
udu	I	Uduk
ues	I	Kioko
ufi	I	Ufim
uga	I	Ugaritic
ugb	I	Kuku-Ugbanh
uge	I	Ughele
ugh	I	Kubachi
ugn	I	Ugandan Sign Language
ugo	I	Ugong
ugy	I	Uruguayan Sign Language
uha	I	Uhami
uhn	I	Damal
uig	I	Uighur
uis	I	Uisai
uiv	I	Iyive
uji	I	Tanjijili
uka	I	Kaburi
ukg	I	Ukuriguma
ukh	I	Ukhwejo
uki	I	Kui (India)
ukk	I	Muak Sa-aak
ukl	I	Ukrainian Sign Language
ukp	I	Ukpe-Bayobiri
ukq	I	Ukwa
ukr	I	Ukrainian
uks	I	Urubú-Kaapor Sign Language
uku	I	Ukue
ukv	I	Kuku
ukw	I	Ukwuani-Aboh-Ndoni
uky	I	Kuuk-Yak
ula	I	Fungwa
ulb	I	Ulukwumi
ulc	I	Ulch
ule	I	Lule
ulf	I	Usku
uli	I	Ulithian
ulk	I	Meriam Mir
ull	I	Ullatan
ulm	I	Ulumanda'
uln	I	Unserdeutsch
ulu	I	Uma' Lung
ulw	I	Ulwa
uly	I	Buli
uma	I	Umatilla
umb	I	Umbundu
umc	I	Marrucinian
umd	I	Umbindhamu
umg	I	Morrobalama
umi	I	Ukit
umm	I	Umon
umn	I	Makyan Naga
umo	I	Umotína
ump	I	Umpila
umr	I	Umbugarla
ums	I	Pendau
umu	I	Munsee
una	I	North Watut
und	S	Undetermined
une	I	Uneme
ung	I	Ngarinyin
uni	I	Uni
unk	I	Enawené-Nawé
unm	I	Unami
unn	I	Kurnai
unr	I	Mundari
unu	I	Unubahe
unx	I	Munda
unz	I	Unde Kaili
uon	I	Kulon
upi	I	Umeda
upv	I	Uripiv-Wala-Rano-Atchin
ura	I	Urarina
urb	I	Urubú-Kaapor
urc	I	Urningangg
urd	I	Urdu
ure	I	Uru
urf	I	Uradhi
urg	I	Urigina
urh	I	Urhobo
uri	I	Urim
urk	I	Urak Lawoi'
url	I	Urali
urm	I	Urapmin
urn	I	Uruangnirin
uro	I	Ura (Papua New Guinea)
urp	I	Uru-Pa-In
urr	I	Lehalurup
urt	I	Urat
uru	I	Urumi
urv	I	Uruava
urw	I	Sop
urx	I	Urimo
ury	I	Orya
urz	I	Uru-Eu-Wau-Wau
usa	I	Usarufa
ush	I	Ushojo
usi	I	Usui
usk	I	Usaghade
usp	I	Uspanteco
uss	I	us-Saare
usu	I	Uya
uta	I	Otank
ute	I	Ute-Southern Paiute
uth	I	ut-Hun
utp	I	Amba (Solomon Islands)
utr	I	Etulo
utu	I	Utu
uum	I	Urum
uur	I	Ura (Vanuatu)
uuu	I	U
uve	I	West Uvean
uvh	I	Uri
uvl	I	Lote
uwa	I	Kuku-Uwanh
uya	I	Doko-Uyanga
uzb	M	Uzbek
uzn	I	Northern Uzbek
uzs	I	Southern Uzbek
vaa	I	Vaagri Booli
vae	I	Vale
vaf	I	Vafsi
vag	I	Vagla
vah	I	Varhadi-Nagpuri
vai	I	Vai
vaj	I	Sekele
val	I	Vehes
vam	I	Vanimo
van	I	Valman
vao	I	Vao
vap	I	Vaiphei
var	I	Huarijio
vas	I	Vasavi
vau	I	Vanuma
vav	I	Varli
vay	I	Wayu
vbb	I	Southeast Babar
vbk	I	Southwestern Bontok
vec	I	Venetian
ved	I	Veddah
vel	I	Veluws
vem	I	Vemgo-Mabas
ven	I	Venda
veo	I	Ventureño
vep	I	Veps
ver	I	Mom Jango
vgr	I	Vaghri
vgt	I	Vlaamse Gebarentaal
vic	I	Virgin Islands Creole English
vid	I	Vidunda
vie	I	Vietnamese
vif	I	Vili
vig	I	Viemo
vil	I	Vilela
vin	I	Vinza
vis	I	Vishavan
vit	I	Viti
viv	I	Iduna
vjk	I	Bajjika
vka	I	Kariyarra
vkj	I	Kujarge
vkk	I	Kaur
vkl	I	Kulisusu
vkm	I	Kamakan
vkn	I	Koro Nulu
vko	I	Kodeoha
vkp	I	Korlai Creole Portuguese
vkt	I	Tenggarong Kutai Malay
vku	I	Kurrama
vkz	I	Koro Zuba
vlp	I	Valpei
vls	I	Vlaams
vma	I	Martuyhunira
vmb	I	Barbaram
vmc	I	Juxtlahuaca Mixtec
vmd	I	Mudu Koraga
vme	I	East Masela
vmf	I	Mainfränkisch
vmg	I	Lungalunga
vmh	I	Maraghei
vmi	I	Miwa
vmj	I	Ixtayutla Mixtec
vmk	I	Makhuwa-Shirima
vml	I	Malgana
vmm	I	Mitlatongo Mixtec
vmp	I	Soyaltepec Mazatec
vmq	I	Soyaltepec Mixtec
vmr	I	Marenje
vms	I	Moksela
vmu	I	Muluridyi
vmv	I	Valley Maidu
vmw	I	Makhuwa
vmx	I	Tamazola Mixtec
vmy	I	Ayautla Mazatec
vmz	I	Mazatlán Mazatec
vnk	I	Vano
vnm	I	Vinmavis
vnp	I	Vunapu
vol	I	Volapük
vor	I	Voro
vot	I	Votic
vra	I	Vera'a
vro	I	Võro
vrs	I	Varisi
vrt	I	Burmbar
vsi	I	Moldova Sign Language
vsl	I	Venezuelan Sign Language
vsn	I	Vedic Sanskrit
vsv	I	Valencian Sign Language
vto	I	Vitou
vum	I	Vumbu
vun	I	Vunjo
vut	I	Vute
vwa	I	Awa (China)
waa	I	Walla Walla
wab	I	Wab
wac	I	Wasco-Wishram
wad	I	Wamesa
wae	I	Walser
waf	I	Wakoná
wag	I	Wa'ema
wah	I	Watubela
wai	I	Wares
waj	I	Waffa
wal	I	Wolaytta
wam	I	Wampanoag
wan	I	Wan
wao	I	Wappo
wap	I	Wapishana
waq	I	Wagiman
war	I	Waray (Philippines)
was	I	Washo
wat	I	Kaninuwa
wau	I	Waurá
wav	I	Waka
waw	I	Waiwai
wax	I	Watam
way	I	Wayana
waz	I	Wampur
wba	I	Warao
wbb	I	Wabo
wbe	I	Waritai
wbf	I	Wara
wbh	I	Wanda
wbi	I	Vwanji
wbj	I	Alagwa
wbk	I	Waigali
wbl	I	Wakhi
wbm	I	Wa
wbp	I	Warlpiri
wbq	I	Waddar
wbr	I	Wagdi
wbs	I	West Bengal Sign Language
wbt	I	Warnman
wbv	I	Wajarri
wbw	I	Woi
wca	I	Yanomámi
wci	I	Waci Gbe
wdd	I	Wandji
wdg	I	Wadaginam
wdj	I	Wadjiginy
wdk	I	Wadikali
wdt	I	Wendat
wdu	I	Wadjigu
wdy	I	Wadjabangayi
wea	I	Wewaw
wec	I	Wè Western
wed	I	Wedau
weg	I	Wergaia
weh	I	Weh
wei	I	Kiunum
wem	I	Weme Gbe
weo	I	Wemale
wep	I	Westphalien
wer	I	Weri
wes	I	Cameroon Pidgin
wet	I	Perai
weu	I	Rawngtu Chin
wew	I	Wejewa
wfg	I	Yafi
wga	I	Wagaya
wgb	I	Wagawaga
wgg	I	Wangkangurru
wgi	I	Wahgi
wgo	I	Waigeo
wgu	I	Wirangu
wgy	I	Warrgamay
wha	I	Sou Upaa
whg	I	North Wahgi
whk	I	Wahau Kenyah
whu	I	Wahau Kayan
wib	I	Southern Toussian
wic	I	Wichita
wie	I	Wik-Epa
wif	I	Wik-Keyangan
wig	I	Wik Ngathan
wih	I	Wik-Me'anha
wii	I	Minidien
wij	I	Wik-Iiyanh
wik	I	Wikalkan
wil	I	Wilawila
wim	I	Wik-Mungkan
win	I	Ho-Chunk
wir	I	Wiraféd
wiu	I	Wiru
wiv	I	Vitu
wiy	I	Wiyot
wja	I	Waja
wji	I	Warji
wka	I	Kw'adza
wkb	I	Kumbaran
wkd	I	Wakde
wkl	I	Kalanadi
wkr	I	Keerray-Woorroong
wku	I	Kunduvadi
wkw	I	Wakawaka
wky	I	Wangkayutyuru
wla	I	Walio
wlc	I	Mwali Comorian
wle	I	Wolane
wlg	I	Kunbarlang
wlh	I	Welaun
wli	I	Waioli
wlk	I	Wailaki
wll	I	Wali (Sudan)
wlm	I	Middle Welsh
wln	I	Walloon
wlo	I	Wolio
wlr	I	Wailapa
wls	I	Wallisian
wlu	I	Wuliwuli
wlv	I	Wichí Lhamtés Vejoz
wlw	I	Walak
wlx	I	Wali (Ghana)
wly	I	Waling
wma	I	Mawa (Nigeria)
wmb	I	Wambaya
wmc	I	Wamas
wmd	I	Mamaindé
wme	I	Wambule
wmg	I	Western Minyag
wmh	I	Waima'a
wmi	I	Wamin
wmm	I	Maiwa (Indonesia)
wmn	I	Waamwang
wmo	I	Wom (Papua New Guinea)
wms	I	Wambon
wmt	I	Walmajarri
wmw	I	Mwani
wmx	I	Womo
wnb	I	Mokati
wnc	I	Wantoat
wnd	I	Wandarang
wne	I	Waneci
wng	I	Wanggom
wni	I	Ndzwani Comorian
wnk	I	Wanukaka
wnm	I	Wanggamala
wnn	I	Wunumara
wno	I	Wano
wnp	I	Wanap
wnu	I	Usan
wnw	I	Wintu
wny	I	Wanyi
woa	I	Kuwema
wob	I	Wè Northern
woc	I	Wogeo
wod	I	Wolani
woe	I	Woleaian
wof	I	Gambian Wolof
wog	I	Wogamusin
woi	I	Kamang
wok	I	Longto
wol	I	Wolof
wom	I	Wom (Nigeria)
won	I	Wongo
woo	I	Manombai
wor	I	Woria
wos	I	Hanga Hundi
wow	I	Wawonii
woy	I	Weyto
wpc	I	Maco
wrb	I	Waluwarra
wrg	I	Warungu
wrh	I	Wiradjuri
wri	I	Wariyangga
wrk	I	Garrwa
wrl	I	Warlmanpa
wrm	I	Warumungu
wrn	I	Warnang
wro	I	Worrorra
wrp	I	Waropen
wrr	I	Wardaman
wrs	I	Waris
wru	I	Waru
wrv	I	Waruna
wrw	I	Gugu Warra
wrx	I	Wae Rana
wry	I	Merwari
wrz	I	Waray (Australia)
wsa	I	Warembori
wsg	I	Adilabad Gondi
wsi	I	Wusi
wsk	I	Waskia
wsr	I	Owenia
wss	I	Wasa
wsu	I	Wasu
wsv	I	Wotapuri-Katarqalai
wtb	I	Matambwe
wtf	I	Watiwa
wth	I	Wathawurrung
wti	I	Berta
wtk	I	Watakataui
wtm	I	Mewati
wtw	I	Wotu
wua	I	Wikngenchera
wub	I	Wunambal
wud	I	Wudu
wuh	I	Wutunhua
wul	I	Silimo
wum	I	Wumbvu
wun	I	Bungu
wur	I	Wurrugu
wut	I	Wutung
wuu	I	Wu Chinese
wuv	I	Wuvulu-Aua
wux	I	Wulna
wuy	I	Wauyai
wwa	I	Waama
wwb	I	Wakabunga
wwo	I	Wetamut
wwr	I	Warrwa
www	I	Wawa
wxa	I	Waxianghua
wxw	I	Wardandi
wyb	I	Wangaaybuwan-Ngiyambaa
wyi	I	Woiwurrung
wym	I	Wymysorys
wyn	I	Wyandot
wyr	I	Wayoró
wyy	I	Western Fijian
xaa	I	Andalusian Arabic
xab	I	Sambe
xac	I	Kachari
xad	I	Adai
xae	I	Aequian
xag	I	Aghwan
xai	I	Kaimbé
xaj	I	Ararandewára
xak	I	Máku
xal	I	Kalmyk
xam	I	ǀXam
xan	I	Xamtanga
xao	I	Khao
xap	I	Apalachee
xaq	I	Aquitanian
xar	I	Karami
xas	I	Kamas
xat	I	Katawixi
xau	I	Kauwera
xav	I	Xavánte
xaw	I	Kawaiisu
xay	I	Kayan Mahakam
xbb	I	Lower Burdekin
xbc	I	Bactrian
xbd	I	Bindal
xbe	I	Bigambal
xbg	I	Bunganditj
xbi	I	Kombio
xbj	I	Birrpayi
xbm	I	Middle Breton
xbn	I	Kenaboi
xbo	I	Bolgarian
xbp	I	Bibbulman
xbr	I	Kambera
xbw	I	Kambiwá
xby	I	Batjala
xcb	I	Cumbric
xcc	I	Camunic
xce	I	Celtiberian
xcg	I	Cisalpine Gaulish
xch	I	Chemakum
xcl	I	Classical Armenian
xcm	I	Comecrudo
xcn	I	Cotoname
xco	I	Chorasmian
xcr	I	Carian
xct	I	Classical Tibetan
xcu	I	Curonian
xcv	I	Chuvantsy
xcw	I	Coahuilteco
xcy	I	Cayuse
xda	I	Darkinyung
xdc	I	Dacian
xdk	I	Dharuk
xdm	I	Edomite
xdo	I	Kwandu
xdq	I	Kaitag
xdy	I	Malayic Dayak
xeb	I	Eblan
xed	I	Hdi
xeg	I	ǁXegwi
xel	I	Kelo
xem	I	Kembayan
xep	I	Epi-Olmec
xer	I	Xerénte
xes	I	Kesawai
xet	I	Xetá
xeu	I	Keoru-Ahia
xfa	I	Faliscan
xga	I	Galatian
xgb	I	Gbin
xgd	I	Gudang
xgf	I	Gabrielino-Fernandeño
xgg	I	Goreng
xgi	I	Garingbal
xgl	I	Galindan
xgm	I	Dharumbal
xgr	I	Garza
xgu	I	Unggumi
xgw	I	Guwa
xha	I	Harami
xhc	I	Hunnic
xhd	I	Hadrami
xhe	I	Khetrani
xhm	I	Middle Khmer (1400 to 1850 CE)
xho	I	Xhosa
xhr	I	Hernican
xht	I	Hattic
xhu	I	Hurrian
xhv	I	Khua
xib	I	Iberian
xii	I	Xiri
xil	I	Illyrian
xin	I	Xinca
xir	I	Xiriâna
xis	I	Kisan
xiv	I	Indus Valley Language
xiy	I	Xipaya
xjb	I	Minjungbal
xjt	I	Jaitmatang
xka	I	Kalkoti
xkb	I	Northern Nago
xkc	I	Kho'ini
xkd	I	Mendalam Kayan
xke	I	Kereho
xkf	I	Khengkha
xkg	I	Kagoro
xki	I	Kenyan Sign Language
xkj	I	Kajali
xkk	I	Kachok
xkl	I	Mainstream Kenyah
xkn	I	Kayan River Kayan
xko	I	Kiorr
xkp	I	Kabatei
xkq	I	Koroni
xkr	I	Xakriabá
xks	I	Kumbewaha
xkt	I	Kantosi
xku	I	Kaamba
xkv	I	Kgalagadi
xkw	I	Kembra
xkx	I	Karore
xky	I	Uma' Lasan
xkz	I	Kurtokha
xla	I	Kamula
xlb	I	Loup B
xlc	I	Lycian
xld	I	Lydian
xle	I	Lemnian
xlg	I	Ligurian (Ancient)
xli	I	Liburnian
xln	I	Alanic
xlo	I	Loup A
xlp	I	Lepontic
xls	I	Lusitanian
xlu	I	Cuneiform Luwian
xly	I	Elymian
xma	I	Mushungulu
xmb	I	Mbonga
xmc	I	Makhuwa-Marrevone
xmd	I	Mbudum
xme	I	Median
xmf	I	Mingrelian
xmg	I	Mengaka
xmh	I	Kugu-Muminh
xmj	I	Majera
xmk	I	Ancient Macedonian
xml	I	Malaysian Sign Language
xmm	I	Manado Malay
xmn	I	Manichaean Middle Persian
xmo	I	Morerebi
xmp	I	Kuku-Mu'inh
xmq	I	Kuku-Mangk
xmr	I	Meroitic
xms	I	Moroccan Sign Language
xmt	I	Matbat
xmu	I	Kamu
xmv	I	Antankarana Malagasy
xmw	I	Tsimihety Malagasy
xmx	I	Salawati
xmy	I	Mayaguduna
xmz	I	Mori Bawah
xna	I	Ancient North Arabian
xnb	I	Kanakanabu
xng	I	Middle Mongolian
xnh	I	Kuanhua
xni	I	Ngarigu
xnj	I	Ngoni (Tanzania)
xnk	I	Nganakarti
xnm	I	Ngumbarl
xnn	I	Northern Kankanay
xno	I	Anglo-Norman
xnq	I	Ngoni (Mozambique)
xnr	I	Kangri
xns	I	Kanashi
xnt	I	Narragansett
xnu	I	Nukunul
xny	I	Nyiyaparli
xnz	I	Kenzi
xoc	I	O'chi'chi'
xod	I	Kokoda
xog	I	Soga
xoi	I	Kominimung
xok	I	Xokleng
xom	I	Komo (Sudan)
xon	I	Konkomba
xoo	I	Xukurú
xop	I	Kopar
xor	I	Korubo
xow	I	Kowaki
xpa	I	Pirriya
xpb	I	Northeastern Tasmanian
xpc	I	Pecheneg
xpd	I	Oyster Bay Tasmanian
xpe	I	Liberia Kpelle
xpf	I	Southeast Tasmanian
xpg	I	Phrygian
xph	I	North Midlands Tasmanian
xpi	I	Pictish
xpj	I	Mpalitjanh
xpk	I	Kulina Pano
xpl	I	Port Sorell Tasmanian
xpm	I	Pumpokol
xpn	I	Kapinawá
xpo	I	Pochutec
xpp	I	Puyo-Paekche
xpq	I	Mohegan-Pequot
xpr	I	Parthian
xps	I	Pisidian
xpt	I	Punthamara
xpu	I	Punic
xpv	I	Northern Tasmanian
xpw	I	Northwestern Tasmanian
xpx	I	Southwestern Tasmanian
xpy	I	Puyo
xpz	I	Bruny Island Tasmanian
xqa	I	Karakhanid
xqt	I	Qatabanian
xra	I	Krahô
xrb	I	Eastern Karaboro
xrd	I	Gundungurra
xre	I	Kreye
xrg	I	Minang
xri	I	Krikati-Timbira
xrm	I	Armazic
xrn	I	Arin
xrr	I	Raetic
xrt	I	Aranama-Tamique
xru	I	Marriammu
xrw	I	Karawa
xsa	I	Sabaean
xsb	I	Sambal
xsc	I	Scythian
xsd	I	Sidetic
xse	I	Sempan
xsh	I	Shamang
xsi	I	Sio
xsj	I	Subi
xsl	I	South Slavey
xsm	I	Kasem
xsn	I	Sanga (Nigeria)
xso	I	Solano
xsp	I	Silopi
xsq	I	Makhuwa-Saka
xsr	I	Sherpa
xsu	I	Sanumá
xsv	I	Sudovian
xsy	I	Saisiyat
xta	I	Alcozauca Mixtec
xtb	I	Chazumba Mixtec
xtc	I	Katcha-Kadugli-Miri
xtd	I	Diuxi-Tilantongo Mixtec
xte	I	Ketengban
xtg	I	Transalpine Gaulish
xth	I	Yitha Yitha
xti	I	Sinicahua Mixtec
xtj	I	San Juan Teita Mixtec
xtl	I	Tijaltepec Mixtec
xtm	I	Magdalena Peñasco Mixtec
xtn	I	Northern Tlaxiaco Mixtec
xto	I	Tokharian A
xtp	I	San Miguel Piedras Mixtec
xtq	I	Tumshuqese
xtr	I	Early Tripuri
xts	I	Sindihui Mixtec
xtt	I	Tacahua Mixtec
xtu	I	Cuyamecalco Mixtec
xtv	I	Thawa
xtw	I	Tawandê
xty	I	Yoloxochitl Mixtec
xua	I	Alu Kurumba
xub	I	Betta Kurumba
xud	I	Umiida
xug	I	Kunigami
xuj	I	Jennu Kurumba
xul	I	Ngunawal
xum	I	Umbrian
xun	I	Unggaranggu
xuo	I	Kuo
xup	I	Upper Umpqua
xur	I	Urartian
xut	I	Kuthant
xuu	I	Kxoe
xve	I	Venetic
xvi	I	Kamviri
xvn	I	Vandalic
xvo	I	Volscian
xvs	I	Vestinian
xwa	I	Kwaza
xwc	I	Woccon
xwd	I	Wadi Wadi
xwe	I	Xwela Gbe
xwg	I	Kwegu
xwj	I	Wajuk
xwk	I	Wangkumara
xwl	I	Western Xwla Gbe
xwo	I	Written Oirat
xwr	I	Kwerba Mamberamo
xwt	I	Wotjobaluk
xww	I	Wemba Wemba
xxb	I	Boro (Ghana)
xxk	I	Ke'o
xxm	I	Minkin
xxr	I	Koropó
xxt	I	Tambora
xya	I	Yaygir
xyb	I	Yandjibara
xyj	I	Mayi-Yapi
xyk	I	Mayi-Kulan
xyl	I	Yalakalore
xyt	I	Mayi-Thakurti
xyy	I	Yorta Yorta
xzh	I	Zhang-Zhung
xzm	I	Zemgalian
xzp	I	Ancient Zapotec
yaa	I	Yaminahua
yab	I	Yuhup
yac	I	Pass Valley Yali
yad	I	Yagua
yae	I	Pumé
yaf	I	Yaka (Democratic Republic of Congo)
yag	I	Yámana
yah	I	Yazgulyam
yai	I	Yagnobi
yaj	I	Banda-Yangere
yak	I	Yakama
yal	I	Yalunka
yam	I	Yamba
yan	I	Mayangna
yao	I	Yao
yap	I	Yapese
yaq	I	Yaqui
yar	I	Yabarana
yas	I	Nugunu (Cameroon)
yat	I	Yambeta
yau	I	Yuwana
yav	I	Yangben
yaw	I	Yawalapití
yax	I	Yauma
yay	I	Agwagwune
yaz	I	Lokaa
yba	I	Yala
ybb	I	Yemba
ybe	I	West Yugur
ybh	I	Yakha
ybi	I	Yamphu
ybj	I	Hasha
ybk	I	Bokha
ybl	I	Yukuben
ybm	I	Yaben
ybn	I	Yabaâna
ybo	I	Yabong
ybx	I	Yawiyo
yby	I	Yaweyuha
ych	I	Chesu
ycl	I	Lolopo
ycn	I	Yucuna
ycp	I	Chepya
ycr	I	Yilan Creole
yda	I	Yanda
ydd	I	Eastern Yiddish
yde	I	Yangum Dey
ydg	I	Yidgha
ydk	I	Yoidik
yea	I	Ravula
yec	I	Yeniche
yee	I	Yimas
yei	I	Yeni
yej	I	Yevanic
yel	I	Yela
yer	I	Tarok
yes	I	Nyankpa
yet	I	Yetfa
yeu	I	Yerukula
yev	I	Yapunda
yey	I	Yeyi
yga	I	Malyangapa
ygi	I	Yiningayi
ygl	I	Yangum Gel
ygm	I	Yagomi
ygp	I	Gepo
ygr	I	Yagaria
ygs	I	Yolŋu Sign Language
ygu	I	Yugul
ygw	I	Yagwoia
yha	I	Baha Buyang
yhd	I	Judeo-Iraqi Arabic
yhl	I	Hlepho Phowa
yhs	I	Yan-nhaŋu Sign Language
yia	I	Yinggarda
yid	M	Yiddish
yif	I	Ache
yig	I	Wusa Nasu
yih	I	Western Yiddish
yii	I	Yidiny
yij	I	Yindjibarndi
yik	I	Dongshanba Lalo
yil	I	Yindjilandji
yim	I	Yimchungru Naga
yin	I	Riang Lai
yip	I	Pholo
yiq	I	Miqie
yir	I	North Awyu
yis	I	Yis
yit	I	Eastern Lalu
yiu	I	Awu
yiv	I	Northern Nisu
yix	I	Axi Yi
yiz	I	Azhe
yka	I	Yakan
ykg	I	Northern Yukaghir
ykh	I	Khamnigan Mongol
yki	I	Yoke
ykk	I	Yakaikeke
ykl	I	Khlula
ykm	I	Kap
ykn	I	Kua-nsi
yko	I	Yasa
ykr	I	Yekora
ykt	I	Kathu
yku	I	Kuamasi
yky	I	Yakoma
yla	I	Yaul
ylb	I	Yaleba
yle	I	Yele
ylg	I	Yelogu
yli	I	Angguruk Yali
yll	I	Yil
ylm	I	Limi
yln	I	Langnian Buyang
ylo	I	Naluo Yi
ylr	I	Yalarnnga
ylu	I	Aribwaung
yly	I	Nyâlayu
ymb	I	Yambes
ymc	I	Southern Muji
ymd	I	Muda
yme	I	Yameo
ymg	I	Yamongeri
ymh	I	Mili
ymi	I	Moji
ymk	I	Makwe
yml	I	Iamalele
ymm	I	Maay
ymn	I	Yamna
ymo	I	Yangum Mon
ymp	I	Yamap
ymq	I	Qila Muji
ymr	I	Malasar
yms	I	Mysian
ymx	I	Northern Muji
ymz	I	Muzi
yna	I	Aluo
ynb	I	Yamben
ynd	I	Yandruwandha
yne	I	Lang'e
yng	I	Yango
ynk	I	Naukan Yupik
ynl	I	Yangulam
ynn	I	Yana
yno	I	Yong
ynq	I	Yendang
yns	I	Yansi
ynu	I	Yahuna
yob	I	Yoba
yog	I	Yogad
yoi	I	Yonaguni
yok	I	Yokuts
yol	I	Yola
yom	I	Yombe
yon	I	Yongkom
yor	I	Yoruba
yot	I	Yotti
yox	I	Yoron
yoy	I	Yoy
ypa	I	Phala
ypb	I	Labo Phowa
ypg	I	Phola
yph	I	Phupha
ypm	I	Phuma
ypn	I	Ani Phowa
ypo	I	Alo Phola
ypp	I	Phupa
ypz	I	Phuza
yra	I	Yerakai
yrb	I	Yareba
yre	I	Yaouré
yrk	I	Nenets
yrl	I	Nhengatu
yrm	I	Yirrk-Mel
yrn	I	Yerong
yro	I	Yaroamë
yrs	I	Yarsun
yrw	I	Yarawata
yry	I	Yarluyandi
ysc	I	Yassic
ysd	I	Samatao
ysg	I	Sonaga
ysl	I	Yugoslavian Sign Language
ysm	I	Myanmar Sign Language
ysn	I	Sani
yso	I	Nisi (China)
ysp	I	Southern Lolopo
ysr	I	Sirenik Yupik
yss	I	Yessan-Mayo
ysy	I	Sanie
yta	I	Talu
ytl	I	Tanglang
ytp	I	Thopho
ytw	I	Yout Wam
yty	I	Yatay
yua	I	Yucateco
yub	I	Yugambal
yuc	I	Yuchi
yud	I	Judeo-Tripolitanian Arabic
yue	I	Yue Chinese
yuf	I	Havasupai-Walapai-Yavapai
yug	I	Yug
yui	I	Yurutí
yuj	I	Karkar-Yuri
yuk	I	Yuki
yul	I	Yulu
yum	I	Quechan
yun	I	Bena (Nigeria)
yup	I	Yukpa
yuq	I	Yuqui
yur	I	Yurok
yut	I	Yopno
yuw	I	Yau (Morobe Province)
yux	I	Southern Yukaghir
yuy	I	East Yugur
yuz	I	Yuracare
yva	I	Yawa
yvt	I	Yavitero
ywa	I	Kalou
ywg	I	Yinhawangka
ywl	I	Western Lalu
ywn	I	Yawanawa
ywq	I	Wuding-Luquan Yi
ywr	I	Yawuru
ywt	I	Xishanba Lalo
ywu	I	Wumeng Nasu
yww	I	Yawarawarga
yxa	I	Mayawali
yxg	I	Yagara
yxl	I	Yardliyawarra
yxm	I	Yinwum
yxu	I	Yuyu
yxy	I	Yabula Yabula
yyr	I	Yir Yoront
yyu	I	Yau (Sandaun Province)
yyz	I	Ayizi
yzg	I	E'ma Buyang
yzk	I	Zokhuo
zaa	I	Sierra de Juárez Zapotec
zab	I	Western Tlacolula Valley Zapotec
zac	I	Ocotlán Zapotec
zad	I	Cajonos Zapotec
zae	I	Yareni Zapotec
zaf	I	Ayoquesco Zapotec
zag	I	Zaghawa
zah	I	Zangwal
zai	I	Isthmus Zapotec
zaj	I	Zaramo
zak	I	Zanaki
zal	I	Zauzou
zam	I	Miahuatlán Zapotec
zao	I	Ozolotepec Zapotec
zap	M	Zapotec
zaq	I	Aloápam Zapotec
zar	I	Rincón Zapotec
zas	I	Santo Domingo Albarradas Zapotec
zat	I	Tabaa Zapotec
zau	I	Zangskari
zav	I	Yatzachi Zapotec
zaw	I	Mitla Zapotec
zax	I	Xadani Zapotec
zay	I	Zayse-Zergulla
zaz	I	Zari
zba	I	Balaibalan
zbc	I	Central Berawan
zbe	I	East Berawan
zbl	I	Blissymbols
zbt	I	Batui
zbu	I	Bu (Bauchi State)
zbw	I	West Berawan
zca	I	Coatecas Altas Zapotec
zcd	I	Las Delicias Zapotec
zch	I	Central Hongshuihe Zhuang
zdj	I	Ngazidja Comorian
zea	I	Zeeuws
zeg	I	Zenag
zeh	I	Eastern Hongshuihe Zhuang
zem	I	Zeem
zen	I	Zenaga
zga	I	Kinga
zgb	I	Guibei Zhuang
zgh	I	Standard Moroccan Tamazight
zgm	I	Minz Zhuang
zgn	I	Guibian Zhuang
zgr	I	Magori
zha	M	Zhuang
zhb	I	Zhaba
zhd	I	Dai Zhuang
zhi	I	Zhire
zhn	I	Nong Zhuang
zho	M	Chinese
zhw	I	Zhoa
zia	I	Zia
zib	I	Zimbabwe Sign Language
zik	I	Zimakani
zil	I	Zialo
zim	I	Mesme
zin	I	Zinza
ziw	I	Zigula
ziz	I	Zizilivakan
zka	I	Kaimbulawa
zkd	I	Kadu
zkg	I	Koguryo
zkh	I	Khorezmian
zkk	I	Karankawa
zkn	I	Kanan
zko	I	Kott
zkp	I	São Paulo Kaingáng
zkr	I	Zakhring
zkt	I	Kitan
zku	I	Kaurna
zkv	I	Krevinian
zkz	I	Khazar
zla	I	Zula
zlj	I	Liujiang Zhuang
zlm	I	Malay (individual language)
zln	I	Lianshan Zhuang
zlq	I	Liuqian Zhuang
zlu	I	Zul
zma	I	Manda (Australia)
zmb	I	Zimba
zmc	I	Margany
zmd	I	Maridan
zme	I	Mangerr
zmf	I	Mfinu
zmg	I	Marti Ke
zmh	I	Makolkol
zmi	I	Negeri Sembilan Malay
zmj	I	Maridjabin
zmk	I	Mandandanyi
zml	I	Matngala
zmm	I	Marimanindji
zmn	I	Mbangwe
zmo	I	Molo
zmp	I	Mbuun
zmq	I	Mituku
zmr	I	Maranunggu
zms	I	Mbesa
zmt	I	Maringarr
zmu	I	Muruwari
zmv	I	Mbariman-Gudhinma
zmw	I	Mbo (Democratic Republic of Congo)
zmx	I	Bomitaba
zmy	I	Mariyedi
zmz	I	Mbandja
zna	I	Zan Gula
zne	I	Zande (individual language)
zng	I	Mang
znk	I	Manangkari
zns	I	Mangas
zoc	I	Copainalá Zoque
zoh	I	Chimalapa Zoque
zom	I	Zou
zoo	I	Asunción Mixtepec Zapotec
zoq	I	Tabasco Zoque
zor	I	Rayón Zoque
zos	I	Francisco León Zoque
zpa	I	Lachiguiri Zapotec
zpb	I	Yautepec Zapotec
zpc	I	Choapan Zapotec
zpd	I	Southeastern Ixtlán Zapotec
zpe	I	Petapa Zapotec
zpf	I	San Pedro Quiatoni Zapotec
zpg	I	Guevea De Humboldt Zapotec
zph	I	Totomachapan Zapotec
zpi	I	Santa María Quiegolani Zapotec
zpj	I	Quiavicuzas Zapotec
zpk	I	Tlacolulita Zapotec
zpl	I	Lachixío Zapotec
zpm	I	Mixtepec Zapotec
zpn	I	Santa Inés Yatzechi Zapotec
zpo	I	Amatlán Zapotec
zpp	I	El Alto Zapotec
zpq	I	Zoogocho Zapotec
zpr	I	Santiago Xanica Zapotec
zps	I	Coatlán Zapotec
zpt	I	San Vicente Coatlán Zapotec
zpu	I	Yalálag Zapotec
zpv	I	Chichicapan Zapotec
zpw	I	Zaniza Zapotec
zpx	I	San Baltazar Loxicha Zapotec
zpy	I	Mazaltepec Zapotec
zpz	I	Texmelucan Zapotec
zqe	I	Qiubei Zhuang
zra	I	Kara (Korea)
zrg	I	Mirgan
zrn	I	Zerenkel
zro	I	Záparo
zrp	I	Zarphatic
zrs	I	Mairasi
zsa	I	Sarasira
zsk	I	Kaskean
zsl	I	Zambian Sign Language
zsm	I	Standard Malay
zsr	I	Southern Rincon Zapotec
zsu	I	Sukurum
zte	I	Elotepec Zapotec
ztg	I	Xanaguía Zapotec
ztl	I	Lapaguía-Guivini Zapotec
ztm	I	San Agustín Mixtepec Zapotec
ztn	I	Santa Catarina Albarradas Zapotec
ztp	I	Loxicha Zapotec
ztq	I	Quioquitani-Quierí Zapotec
zts	I	Tilquiapan Zapotec
ztt	I	Tejalapan Zapotec
ztu	I	Güilá Zapotec
ztx	I	Zaachila Zapotec
zty	I	Yatee Zapotec
zuh	I	Tokano
zul	I	Zulu
zum	I	Kumzari
zun	I	Zuni
zuy	I	Zumaya
zwa	I	Zay
zxx	S	No linguistic content
zyb	I	Yongbei Zhuang
zyg	I	Yang Zhuang
zyj	I	Youjiang Zhuang
zyn	I	Yongnan Zhuang
zyp	I	Zyphe Chin
zza	M	Zaza
zzj	I	Zuojiang Zhuang
